1.194822006472491954e-01 1.241423948220064660e-01 1.249190938511326870e-01 1.227184466019417414e-01 1.170226537216828427e-01 1.140453074433656899e-01 1.122330097087378686e-01 1.096440129449838125e-01 1.122330097087378686e-01 1.137864077669902968e-01 1.174110032362459533e-01 1.220711974110032377e-01 1.246601941747572800e-01 1.277669902912621225e-01 1.319093851132686068e-01 1.325566343042071105e-01 1.343689320388349595e-01 1.347572815533980561e-01 1.354045307443365598e-01 1.307443365695792892e-01 1.263430420711973978e-01
1.236245954692556659e-01 1.284142394822006539e-01 1.304854368932038822e-01 1.269902912621359292e-01 1.242718446601941695e-01 1.190938511326860849e-01 1.192233009708737884e-01 1.135275080906148898e-01 1.155987055016181181e-01 1.202588996763754026e-01 1.218122977346278307e-01 1.266019417475728048e-01 1.319093851132686068e-01 1.334627831715210489e-01 1.359223300970873738e-01 1.376051779935275055e-01 1.392880258899676371e-01 1.387702265372168231e-01 1.376051779935275055e-01 1.333333333333333315e-01 1.298381877022653785e-01
1.231067961165048519e-01 1.306148867313915996e-01 1.321682847896440138e-01 1.317799352750809172e-01 1.308737864077669788e-01 1.263430420711973978e-01 1.212944983818770167e-01 1.180582524271844708e-01 1.203883495145631061e-01 1.223300970873786447e-01 1.251779935275080802e-01 1.337216828478964281e-01 1.378640776699029125e-01 1.386407766990291335e-01 1.386407766990291335e-01 1.413592233009708654e-01 1.425242718446601831e-01 1.408414239482200514e-01 1.416181229773462724e-01 1.366990291262135948e-01 1.344983818770226491e-01
1.207766990291262166e-01 1.260841423948220186e-01 1.316504854368931998e-01 1.328155339805825175e-01 1.307443365695792892e-01 1.245307443365695765e-01 1.232362459546925554e-01 1.205177993527508096e-01 1.214239482200647202e-01 1.250485436893203905e-01 1.282847896440129365e-01 1.364401294498381878e-01 1.413592233009708654e-01 1.418770226537216794e-01 1.435598705501618111e-01 1.434304207119741215e-01 1.439482200647249077e-01 1.430420711974109971e-01 1.412297734627831758e-01 1.398058252427184511e-01 1.365695792880258774e-01
1.180582524271844708e-01 1.250485436893203905e-01 1.286731391585760609e-01 1.288025889967637505e-01 1.267313915857605222e-01 1.220711974110032377e-01 1.214239482200647202e-01 1.219417475728155342e-01 1.238834951456310729e-01 1.259546925566343012e-01 1.282847896440129365e-01 1.322977346278317035e-01 1.370873786407766914e-01 1.411003236245954584e-01 1.435598705501618111e-01 1.449838187702265357e-01 1.439482200647249077e-01 1.429126213592233074e-01 1.405825242718446721e-01 1.404530744336569548e-01 1.360517799352750912e-01
1.154692556634304146e-01 1.220711974110032377e-01 1.251779935275080802e-01 1.259546925566343012e-01 1.250485436893203905e-01 1.207766990291262166e-01 1.198705501618122921e-01 1.205177993527508096e-01 1.275080906148867432e-01 1.282847896440129365e-01 1.290614886731391575e-01 1.338511326860841455e-01 1.365695792880258774e-01 1.407119741100323618e-01 1.429126213592233074e-01 1.460194174757281638e-01 1.458899676375404464e-01 1.429126213592233074e-01 1.404530744336569548e-01 1.377346278317152228e-01 1.334627831715210489e-01
1.137864077669902968e-01 1.206472491909385131e-01 1.233656957928802589e-01 1.259546925566343012e-01 1.234951456310679624e-01 1.228478964401294449e-01 1.222006472491909412e-01 1.194822006472491954e-01 1.246601941747572800e-01 1.280258899676375295e-01 1.295792880258899715e-01 1.352750809061488702e-01 1.350161812297734631e-01 1.347572815533980561e-01 1.395469255663430441e-01 1.391585760517799475e-01 1.412297734627831758e-01 1.420064724919093968e-01 1.386407766990291335e-01 1.332038834951456419e-01 1.295792880258899715e-01
1.123624595469255721e-01 1.189644012944983814e-01 1.250485436893203905e-01 1.260841423948220186e-01 1.234951456310679624e-01 1.211650485436893271e-01 1.218122977346278307e-01 1.228478964401294449e-01 1.269902912621359292e-01 1.276375404530744329e-01 1.289320388349514679e-01 1.348867313915857735e-01 1.354045307443365598e-01 1.344983818770226491e-01 1.316504854368931998e-01 1.352750809061488702e-01 1.368284789644012844e-01 1.376051779935275055e-01 1.359223300970873738e-01 1.285436893203883435e-01 1.236245954692556659e-01
1.113268608414239441e-01 1.209061488673139201e-01 1.250485436893203905e-01 1.245307443365695765e-01 1.256957928802588942e-01 1.228478964401294449e-01 1.242718446601941695e-01 1.264724919093851152e-01 1.282847896440129365e-01 1.288025889967637505e-01 1.308737864077669788e-01 1.328155339805825175e-01 1.354045307443365598e-01 1.324271844660194208e-01 1.317799352750809172e-01 1.319093851132686068e-01 1.355339805825242772e-01 1.356634304207119668e-01 1.313915857605177928e-01 1.277669902912621225e-01 1.190938511326860849e-01
1.153398058252427250e-01 1.202588996763754026e-01 1.244012944983818730e-01 1.244012944983818730e-01 1.251779935275080802e-01 1.249190938511326870e-01 1.254368932038834872e-01 1.281553398058252469e-01 1.306148867313915996e-01 1.289320388349514679e-01 1.298381877022653785e-01 1.320388349514563242e-01 1.338511326860841455e-01 1.310032362459546962e-01 1.313915857605177928e-01 1.290614886731391575e-01 1.302265372168284752e-01 1.337216828478964281e-01 1.298381877022653785e-01 1.267313915857605222e-01 1.177993527508090638e-01
1.171521035598705462e-01 1.206472491909385131e-01 1.247896440129449835e-01 1.273786407766990258e-01 1.278964401294498399e-01 1.269902912621359292e-01 1.258252427184466116e-01 1.285436893203883435e-01 1.286731391585760609e-01 1.285436893203883435e-01 1.306148867313915996e-01 1.328155339805825175e-01 1.325566343042071105e-01 1.312621359223301032e-01 1.295792880258899715e-01 1.278964401294498399e-01 1.286731391585760609e-01 1.288025889967637505e-01 1.260841423948220186e-01 1.212944983818770167e-01 1.128802588996763723e-01
1.194822006472491954e-01 1.253074433656957976e-01 1.293203883495145645e-01 1.310032362459546962e-01 1.308737864077669788e-01 1.311326860841423858e-01 1.278964401294498399e-01 1.285436893203883435e-01 1.304854368932038822e-01 1.297087378640776612e-01 1.295792880258899715e-01 1.306148867313915996e-01 1.319093851132686068e-01 1.291909385113268471e-01 1.290614886731391575e-01 1.263430420711973978e-01 1.275080906148867432e-01 1.259546925566343012e-01 1.240129449838187764e-01 1.175404530744336568e-01 1.097734627831715160e-01
1.244012944983818730e-01 1.290614886731391575e-01 1.335922330097087385e-01 1.366990291262135948e-01 1.348867313915857735e-01 1.335922330097087385e-01 1.312621359223301032e-01 1.307443365695792892e-01 1.294498381877022541e-01 1.298381877022653785e-01 1.298381877022653785e-01 1.308737864077669788e-01 1.302265372168284752e-01 1.284142394822006539e-01 1.273786407766990258e-01 1.247896440129449835e-01 1.258252427184466116e-01 1.242718446601941695e-01 1.205177993527508096e-01 1.140453074433656899e-01 1.074433656957928807e-01
1.285436893203883435e-01 1.328155339805825175e-01 1.372168284789644088e-01 1.391585760517799475e-01 1.401941747572815478e-01 1.373462783171520984e-01 1.328155339805825175e-01 1.332038834951456419e-01 1.297087378640776612e-01 1.295792880258899715e-01 1.293203883495145645e-01 1.277669902912621225e-01 1.263430420711973978e-01 1.253074433656957976e-01 1.240129449838187764e-01 1.215533980582524237e-01 1.211650485436893271e-01 1.179288025889967673e-01 1.145631067961165039e-01 1.088673139158576053e-01 1.016181229773462785e-01
1.291909385113268471e-01 1.361812297734627808e-01 1.386407766990291335e-01 1.413592233009708654e-01 1.405825242718446721e-01 1.395469255663430441e-01 1.368284789644012844e-01 1.341100323624595525e-01 1.304854368932038822e-01 1.290614886731391575e-01 1.293203883495145645e-01 1.275080906148867432e-01 1.273786407766990258e-01 1.232362459546925554e-01 1.216828478964401272e-01 1.206472491909385131e-01 1.180582524271844708e-01 1.163754045307443391e-01 1.124919093851132618e-01 1.086084142394821983e-01 1.011003236245954645e-01
1.333333333333333315e-01 1.363106796116504982e-01 1.416181229773462724e-01 1.426537216828479004e-01 1.411003236245954584e-01 1.394174757281553267e-01 1.369579288025890018e-01 1.350161812297734631e-01 1.330744336569579245e-01 1.288025889967637505e-01 1.286731391585760609e-01 1.278964401294498399e-01 1.245307443365695765e-01 1.210355987055016236e-01 1.198705501618122921e-01 1.175404530744336568e-01 1.189644012944983814e-01 1.162459546925566356e-01 1.117152103559870546e-01 1.038187702265372103e-01 9.851132686084142220e-02
1.356634304207119668e-01 1.388996763754045405e-01 1.391585760517799475e-01 1.416181229773462724e-01 1.433009708737864041e-01 1.379935275080906021e-01 1.370873786407766914e-01 1.356634304207119668e-01 1.354045307443365598e-01 1.302265372168284752e-01 1.277669902912621225e-01 1.272491909385113362e-01 1.251779935275080802e-01 1.218122977346278307e-01 1.199999999999999956e-01 1.181877022653721743e-01 1.180582524271844708e-01 1.155987055016181181e-01 1.086084142394821983e-01 1.026537216828478927e-01 9.553398058252426939e-02
1.357928802588996842e-01 1.381229773462783195e-01 1.386407766990291335e-01 1.403236245954692651e-01 1.426537216828479004e-01 1.401941747572815478e-01 1.385113268608414161e-01 1.359223300970873738e-01 1.344983818770226491e-01 1.285436893203883435e-01 1.281553398058252469e-01 1.256957928802588942e-01 1.245307443365695765e-01 1.210355987055016236e-01 1.187055016181229744e-01 1.158576051779935251e-01 1.127508090614886688e-01 1.109385113268608475e-01 1.058899676375404525e-01 1.004530744336569609e-01 9.346278317152104109e-02
1.338511326860841455e-01 1.360517799352750912e-01 1.361812297734627808e-01 1.387702265372168231e-01 1.377346278317152228e-01 1.383818770226537265e-01 1.366990291262135948e-01 1.333333333333333315e-01 1.315210355987055102e-01 1.269902912621359292e-01 1.280258899676375295e-01 1.253074433656957976e-01 1.212944983818770167e-01 1.196116504854368989e-01 1.159870550161812286e-01 1.135275080906148898e-01 1.114563106796116476e-01 1.077022653721682877e-01 1.027831715210355962e-01 9.877022653721682921e-02 9.035598705501618477e-02
1.326860841423948278e-01 1.334627831715210489e-01 1.343689320388349595e-01 1.344983818770226491e-01 1.350161812297734631e-01 1.344983818770226491e-01 1.332038834951456419e-01 1.290614886731391575e-01 1.269902912621359292e-01 1.233656957928802589e-01 1.214239482200647202e-01 1.203883495145631061e-01 1.172815533980582497e-01 1.143042071197410969e-01 1.119741100323624616e-01 1.095145631067961228e-01 1.055016181229773420e-01 1.030420711974110032e-01 1.012297734627831680e-01 9.488673139158576575e-02 8.699029126213592145e-02
1.295792880258899715e-01 1.290614886731391575e-01 1.311326860841423858e-01 1.332038834951456419e-01 1.326860841423948278e-01 1.302265372168284752e-01 1.278964401294498399e-01 1.223300970873786447e-01 1.209061488673139201e-01 1.181877022653721743e-01 1.161165048543689321e-01 1.150809061488673180e-01 1.106796116504854405e-01 1.088673139158576053e-01 1.084789644012944948e-01 1.047249190938511348e-01 1.030420711974110032e-01 9.773462783171521506e-02 9.669902912621358704e-02 9.022653721682848127e-02 8.375404530744336162e-02
