1.148977604673807190e-01 1.174015857560161413e-01 1.167060787313951853e-01 1.101683126999582762e-01 1.118375295590485485e-01 1.118375295590485485e-01 1.116984281541243545e-01 1.089164000556405582e-01 1.080817916260954220e-01 1.094728056753373202e-01 1.110029211295034124e-01 1.148977604673807190e-01 1.179579913757128895e-01 1.207400194741966859e-01 1.274168869105578028e-01 1.301989150090415992e-01 1.288079009597996871e-01 1.293643065794964631e-01 1.324245374878286197e-01 1.295034079844206432e-01 1.229656419529837202e-01
1.153150646821532871e-01 1.176797885658645154e-01 1.174015857560161413e-01 1.158714703018500491e-01 1.167060787313951853e-01 1.142022534427597769e-01 1.144804562526081509e-01 1.105856169147308443e-01 1.094728056753373202e-01 1.128112393935178787e-01 1.143413548476839570e-01 1.193490054249547877e-01 1.240784531923772444e-01 1.274168869105578028e-01 1.318681318681318715e-01 1.335373487272221438e-01 1.349283627764640558e-01 1.352065655863124161e-01 1.361802754207817601e-01 1.328418417026011877e-01 1.296425093893448233e-01
1.142022534427597769e-01 1.190708026151064136e-01 1.192099040200306076e-01 1.180970927806370835e-01 1.179579913757128895e-01 1.155932674920016751e-01 1.187925998052580395e-01 1.168451801363193793e-01 1.133676450132146268e-01 1.157323688969258552e-01 1.194881068298789817e-01 1.228265405480595401e-01 1.269995826957852347e-01 1.321463346779802595e-01 1.357629712060091920e-01 1.384058978995687805e-01 1.386841007094171685e-01 1.392405063291139167e-01 1.406315203783558287e-01 1.386841007094171685e-01 1.331200445124495757e-01
1.135067464181388208e-01 1.158714703018500491e-01 1.155932674920016751e-01 1.186534984003338455e-01 1.182361941855612775e-01 1.162887745166226172e-01 1.194881068298789817e-01 1.206009180692725058e-01 1.186534984003338455e-01 1.229656419529837202e-01 1.256085686465433227e-01 1.263040756711642787e-01 1.322854360829044396e-01 1.346501599666156679e-01 1.359020726109333721e-01 1.395187091389623046e-01 1.411879259980525769e-01 1.420225344275977131e-01 1.423007372374461010e-01 1.411879259980525769e-01 1.354847683961608040e-01
1.146195576575323449e-01 1.176797885658645154e-01 1.168451801363193793e-01 1.193490054249547877e-01 1.206009180692725058e-01 1.193490054249547877e-01 1.203227152594241178e-01 1.215746279037418220e-01 1.244957574071498124e-01 1.260258728613158907e-01 1.295034079844206432e-01 1.315899290582834835e-01 1.349283627764640558e-01 1.371539852552510763e-01 1.395187091389623046e-01 1.429962442620670571e-01 1.425789400472944890e-01 1.421616358325219209e-01 1.449436639310056896e-01 1.427180414522186691e-01 1.377103908749478245e-01
1.107247183196550244e-01 1.161496731116984232e-01 1.161496731116984232e-01 1.176797885658645154e-01 1.211573236889692540e-01 1.194881068298789817e-01 1.217137293086660160e-01 1.232438447628321082e-01 1.244957574071498124e-01 1.265822784810126667e-01 1.299207121991932112e-01 1.310335234385867353e-01 1.346501599666156679e-01 1.371539852552510763e-01 1.411879259980525769e-01 1.427180414522186691e-01 1.446654611211573294e-01 1.460564751703992137e-01 1.456391709556266456e-01 1.449436639310056896e-01 1.397969119488106926e-01
1.122548337738211166e-01 1.147586590624565250e-01 1.165669773264709913e-01 1.189317012101822196e-01 1.212964250938934480e-01 1.219919321185143901e-01 1.225483377382111522e-01 1.257476700514675305e-01 1.229656419529837202e-01 1.265822784810126667e-01 1.313117262484350956e-01 1.317290304632076914e-01 1.332591459173737558e-01 1.350674641813882360e-01 1.396578105438864847e-01 1.414661288079009649e-01 1.448045625260815095e-01 1.474474892196411258e-01 1.468910835999443498e-01 1.431353456669912372e-01 1.378494922798720324e-01
1.072471831965502859e-01 1.108638197245792184e-01 1.160105717067742431e-01 1.193490054249547877e-01 1.199054110446515498e-01 1.218528307135902100e-01 1.235220475726804823e-01 1.261649742662400986e-01 1.243566560022256184e-01 1.278341911253303709e-01 1.300598136041173913e-01 1.315899290582834835e-01 1.325636388927528275e-01 1.329809431075253956e-01 1.374321880650994643e-01 1.420225344275977131e-01 1.424398386423702811e-01 1.457782723605508535e-01 1.455000695507024655e-01 1.427180414522186691e-01 1.349283627764640558e-01
1.080817916260954220e-01 1.129503407984420588e-01 1.179579913757128895e-01 1.206009180692725058e-01 1.232438447628321082e-01 1.247739602169981865e-01 1.290861037696480751e-01 1.236611489776046763e-01 1.265822784810126667e-01 1.281123939351787588e-01 1.301989150090415992e-01 1.315899290582834835e-01 1.324245374878286197e-01 1.324245374878286197e-01 1.349283627764640558e-01 1.363193768257059402e-01 1.393796077340381245e-01 1.414661288079009649e-01 1.400751147586590528e-01 1.372930866601752564e-01 1.322854360829044396e-01
1.069689803867019118e-01 1.122548337738211166e-01 1.176797885658645154e-01 1.203227152594241178e-01 1.206009180692725058e-01 1.254694672416191426e-01 1.285296981499513269e-01 1.282514953401029389e-01 1.296425093893448233e-01 1.272777855056335949e-01 1.296425093893448233e-01 1.311726248435109154e-01 1.303380164139657793e-01 1.313117262484350956e-01 1.343719571567672799e-01 1.354847683961608040e-01 1.365975796355543281e-01 1.388232021143413486e-01 1.378494922798720324e-01 1.349283627764640558e-01 1.308944220336625275e-01
1.104465155098066503e-01 1.168451801363193793e-01 1.215746279037418220e-01 1.242175545973014383e-01 1.263040756711642787e-01 1.288079009597996871e-01 1.295034079844206432e-01 1.300598136041173913e-01 1.274168869105578028e-01 1.276950897204061630e-01 1.324245374878286197e-01 1.327027402976770076e-01 1.311726248435109154e-01 1.320072332730560516e-01 1.335373487272221438e-01 1.361802754207817601e-01 1.333982473222979637e-01 1.359020726109333721e-01 1.356238698010849841e-01 1.336764501321463239e-01 1.288079009597996871e-01
1.119766309639727425e-01 1.165669773264709913e-01 1.253303658366949624e-01 1.310335234385867353e-01 1.314508276533593034e-01 1.327027402976770076e-01 1.321463346779802595e-01 1.293643065794964631e-01 1.314508276533593034e-01 1.320072332730560516e-01 1.304771178188899594e-01 1.303380164139657793e-01 1.307553206287383474e-01 1.304771178188899594e-01 1.331200445124495757e-01 1.339546529419947118e-01 1.331200445124495757e-01 1.325636388927528275e-01 1.324245374878286197e-01 1.315899290582834835e-01 1.267213798859368468e-01
1.154541660870774811e-01 1.226874391431353462e-01 1.297816107942690311e-01 1.339546529419947118e-01 1.336764501321463239e-01 1.353456669912366239e-01 1.342328557518430998e-01 1.311726248435109154e-01 1.304771178188899594e-01 1.322854360829044396e-01 1.304771178188899594e-01 1.292252051745722552e-01 1.289470023647238950e-01 1.307553206287383474e-01 1.304771178188899594e-01 1.308944220336625275e-01 1.285296981499513269e-01 1.300598136041173913e-01 1.295034079844206432e-01 1.278341911253303709e-01 1.233829461677562883e-01
1.208791208791208799e-01 1.306162192238141673e-01 1.318681318681318715e-01 1.363193768257059402e-01 1.386841007094171685e-01 1.377103908749478245e-01 1.346501599666156679e-01 1.352065655863124161e-01 1.338155515370705317e-01 1.321463346779802595e-01 1.318681318681318715e-01 1.310335234385867353e-01 1.292252051745722552e-01 1.329809431075253956e-01 1.314508276533593034e-01 1.310335234385867353e-01 1.296425093893448233e-01 1.293643065794964631e-01 1.295034079844206432e-01 1.279732925302545510e-01 1.193490054249547877e-01
1.260258728613158907e-01 1.347892613715398480e-01 1.370148838503268962e-01 1.399360133537348727e-01 1.427180414522186691e-01 1.420225344275977131e-01 1.406315203783558287e-01 1.389623035192655565e-01 1.381276950897203926e-01 1.385449993044929884e-01 1.346501599666156679e-01 1.345110585616914600e-01 1.322854360829044396e-01 1.335373487272221438e-01 1.315899290582834835e-01 1.304771178188899594e-01 1.299207121991932112e-01 1.283905967450271191e-01 1.290861037696480751e-01 1.226874391431353462e-01 1.161496731116984232e-01
1.301989150090415992e-01 1.349283627764640558e-01 1.416052302128251450e-01 1.413270274029767570e-01 1.467519821950201697e-01 1.455000695507024655e-01 1.431353456669912372e-01 1.424398386423702811e-01 1.411879259980525769e-01 1.388232021143413486e-01 1.359020726109333721e-01 1.346501599666156679e-01 1.343719571567672799e-01 1.353456669912366239e-01 1.332591459173737558e-01 1.347892613715398480e-01 1.324245374878286197e-01 1.306162192238141673e-01 1.275559883154819829e-01 1.206009180692725058e-01 1.123939351787453106e-01
1.322854360829044396e-01 1.360411740158575522e-01 1.410488245931283968e-01 1.413270274029767570e-01 1.449436639310056896e-01 1.460564751703992137e-01 1.453609681457782854e-01 1.423007372374461010e-01 1.418834330226735330e-01 1.397969119488106926e-01 1.374321880650994643e-01 1.354847683961608040e-01 1.336764501321463239e-01 1.325636388927528275e-01 1.290861037696480751e-01 1.300598136041173913e-01 1.304771178188899594e-01 1.275559883154819829e-01 1.235220475726804823e-01 1.182361941855612775e-01 1.103074141048824564e-01
1.325636388927528275e-01 1.360411740158575522e-01 1.404924189734316209e-01 1.449436639310056896e-01 1.455000695507024655e-01 1.482820976491862619e-01 1.468910835999443498e-01 1.452218667408540775e-01 1.452218667408540775e-01 1.417443316177493529e-01 1.372930866601752564e-01 1.342328557518430998e-01 1.333982473222979637e-01 1.310335234385867353e-01 1.313117262484350956e-01 1.285296981499513269e-01 1.233829461677562883e-01 1.242175545973014383e-01 1.207400194741966859e-01 1.143413548476839570e-01 1.044651550980664895e-01
1.317290304632076914e-01 1.367366810404785082e-01 1.407706217832800089e-01 1.442481569063847613e-01 1.482820976491862619e-01 1.463346779802476016e-01 1.475865906245653059e-01 1.466128807900959896e-01 1.424398386423702811e-01 1.393796077340381245e-01 1.363193768257059402e-01 1.315899290582834835e-01 1.288079009597996871e-01 1.311726248435109154e-01 1.289470023647238950e-01 1.272777855056335949e-01 1.228265405480595401e-01 1.194881068298789817e-01 1.158714703018500491e-01 1.084990958408679901e-01 9.764918625678119246e-02
1.279732925302545510e-01 1.318681318681318715e-01 1.370148838503268962e-01 1.400751147586590528e-01 1.439699540965363733e-01 1.475865906245653059e-01 1.456391709556266456e-01 1.443872583113089414e-01 1.406315203783558287e-01 1.350674641813882360e-01 1.318681318681318715e-01 1.295034079844206432e-01 1.267213798859368468e-01 1.250521630268465745e-01 1.222701349283627781e-01 1.182361941855612775e-01 1.158714703018500491e-01 1.137849492279872088e-01 1.093337042704131262e-01 1.022395326192794551e-01 9.361524551397969185e-02
1.239393517874530504e-01 1.276950897204061630e-01 1.308944220336625275e-01 1.356238698010849841e-01 1.377103908749478245e-01 1.421616358325219209e-01 1.407706217832800089e-01 1.413270274029767570e-01 1.361802754207817601e-01 1.315899290582834835e-01 1.272777855056335949e-01 1.251912644317707546e-01 1.204618166643483118e-01 1.190708026151064136e-01 1.151759632772290931e-01 1.110029211295034124e-01 1.084990958408679901e-01 1.041869522882181154e-01 1.005703157601891828e-01 9.737098344693281837e-02 8.846849353178466713e-02
