1.161845953851153718e-01 1.124471888202794867e-01 1.122846928826779361e-01 1.104972375690607689e-01 1.096847578810529744e-01 1.083847903802405005e-01 1.052973675658108593e-01 1.051348716282092949e-01 1.002599935001625003e-01 1.020474488137796537e-01 1.072473188170295771e-01 1.116347091322716922e-01 1.143971400714982184e-01 1.165095872603184868e-01 1.200844978875528074e-01 1.208969775755606157e-01 1.231719207019824486e-01 1.241468963275918075e-01 1.236594085147871280e-01 1.215469613259668458e-01 1.173220669483262951e-01
1.166720831979200512e-01 1.160220994475138073e-01 1.147221319467013334e-01 1.126096847578810511e-01 1.145596360090997690e-01 1.124471888202794867e-01 1.075723106922326922e-01 1.074098147546311277e-01 1.048098797530061799e-01 1.074098147546311277e-01 1.095222619434514100e-01 1.145596360090997690e-01 1.199220019499512568e-01 1.210594735131621663e-01 1.247968800779980514e-01 1.272343191420214625e-01 1.272343191420214625e-01 1.256093597660058458e-01 1.244718882027949364e-01 1.221969450763730897e-01 1.189470263243418979e-01
1.116347091322716922e-01 1.148846278843028978e-01 1.161845953851153718e-01 1.139096522586935389e-01 1.156971075723106923e-01 1.139096522586935389e-01 1.088722781930451800e-01 1.091972700682482950e-01 1.062723431914202182e-01 1.093597660058498594e-01 1.101722456938576539e-01 1.142346441338966540e-01 1.191095222619434485e-01 1.246343841403964869e-01 1.272343191420214625e-01 1.293467663308417170e-01 1.277218069548261281e-01 1.262593435164120759e-01 1.230094247643808841e-01 1.241468963275918075e-01 1.226844328891777691e-01
1.108222294442638978e-01 1.147221319467013334e-01 1.166720831979200512e-01 1.132596685082872950e-01 1.140721481962950895e-01 1.174845628859278457e-01 1.117972050698732567e-01 1.126096847578810511e-01 1.075723106922326922e-01 1.095222619434514100e-01 1.124471888202794867e-01 1.171595710107247307e-01 1.233344166395840130e-01 1.267468313292167692e-01 1.295092622684432815e-01 1.309717257068573337e-01 1.303217419564510759e-01 1.285342866428339226e-01 1.283717907052323581e-01 1.270718232044198981e-01 1.231719207019824486e-01
1.074098147546311277e-01 1.116347091322716922e-01 1.126096847578810511e-01 1.140721481962950895e-01 1.132596685082872950e-01 1.169970750731231662e-01 1.143971400714982184e-01 1.119597010074748072e-01 1.111472213194670128e-01 1.132596685082872950e-01 1.143971400714982184e-01 1.191095222619434485e-01 1.243093922651933719e-01 1.262593435164120759e-01 1.293467663308417170e-01 1.319467013324666926e-01 1.340591485212869749e-01 1.337341566460838460e-01 1.308092297692557693e-01 1.303217419564510759e-01 1.231719207019824486e-01
1.065973350666233332e-01 1.095222619434514100e-01 1.101722456938576539e-01 1.132596685082872950e-01 1.113097172570685772e-01 1.168345791355216157e-01 1.160220994475138073e-01 1.160220994475138073e-01 1.160220994475138073e-01 1.132596685082872950e-01 1.189470263243418979e-01 1.213844653883652952e-01 1.267468313292167692e-01 1.283717907052323581e-01 1.293467663308417170e-01 1.321091972700682571e-01 1.330841728956776160e-01 1.329216769580760515e-01 1.317842053948651282e-01 1.295092622684432815e-01 1.252843678908027170e-01
1.056223594410139743e-01 1.038349041273968210e-01 1.085472863178420511e-01 1.113097172570685772e-01 1.122846928826779361e-01 1.143971400714982184e-01 1.156971075723106923e-01 1.186220344491387690e-01 1.181345466363340896e-01 1.191095222619434485e-01 1.204094897627559363e-01 1.230094247643808841e-01 1.262593435164120759e-01 1.283717907052323581e-01 1.291842703932401804e-01 1.312967175820604349e-01 1.293467663308417170e-01 1.301592460188495393e-01 1.304842378940526404e-01 1.277218069548261281e-01 1.239844003899902569e-01
1.000974975625609359e-01 1.015599610009749743e-01 1.077348066298342566e-01 1.109847253818654483e-01 1.117972050698732567e-01 1.158596035099122568e-01 1.161845953851153718e-01 1.166720831979200512e-01 1.194345141371465774e-01 1.192720181995450129e-01 1.215469613259668458e-01 1.254468638284042814e-01 1.286967825804354870e-01 1.298342541436464104e-01 1.304842378940526404e-01 1.306467338316542048e-01 1.290217744556386159e-01 1.280467988300292570e-01 1.264218394540136403e-01 1.233344166395840130e-01 1.195970100747481280e-01
9.636009099772505082e-02 1.025349366265843332e-01 1.057848553786155388e-01 1.095222619434514100e-01 1.103347416314592183e-01 1.121221969450763717e-01 1.124471888202794867e-01 1.174845628859278457e-01 1.179720506987325251e-01 1.202469938251543718e-01 1.231719207019824486e-01 1.262593435164120759e-01 1.269093272668183336e-01 1.264218394540136403e-01 1.265843353916152048e-01 1.269093272668183336e-01 1.260968475788105392e-01 1.254468638284042814e-01 1.262593435164120759e-01 1.204094897627559363e-01 1.156971075723106923e-01
9.961000974975625644e-02 1.054598635034124099e-01 1.098472538186545389e-01 1.114722131946701278e-01 1.096847578810529744e-01 1.142346441338966540e-01 1.191095222619434485e-01 1.205719857003574869e-01 1.200844978875528074e-01 1.236594085147871280e-01 1.247968800779980514e-01 1.264218394540136403e-01 1.280467988300292570e-01 1.285342866428339226e-01 1.273968150796229992e-01 1.280467988300292570e-01 1.291842703932401804e-01 1.282092947676308214e-01 1.244718882027949364e-01 1.181345466363340896e-01 1.104972375690607689e-01
1.012349691257718592e-01 1.077348066298342566e-01 1.103347416314592183e-01 1.129346766330841662e-01 1.160220994475138073e-01 1.184595385115372185e-01 1.194345141371465774e-01 1.221969450763730897e-01 1.226844328891777691e-01 1.243093922651933719e-01 1.234969125771855636e-01 1.252843678908027170e-01 1.265843353916152048e-01 1.298342541436464104e-01 1.275593110172245637e-01 1.291842703932401804e-01 1.278843028924276926e-01 1.265843353916152048e-01 1.217094572635684102e-01 1.178095547611309746e-01 1.100097497562560894e-01
1.067598310042248977e-01 1.106597335066623333e-01 1.143971400714982184e-01 1.197595060123496924e-01 1.223594410139746541e-01 1.215469613259668458e-01 1.205719857003574869e-01 1.204094897627559363e-01 1.217094572635684102e-01 1.236594085147871280e-01 1.249593760155996158e-01 1.247968800779980514e-01 1.257718557036074103e-01 1.262593435164120759e-01 1.273968150796229992e-01 1.272343191420214625e-01 1.256093597660058458e-01 1.247968800779980514e-01 1.212219694507637308e-01 1.122846928826779361e-01 1.057848553786155388e-01
1.096847578810529744e-01 1.168345791355216157e-01 1.194345141371465774e-01 1.243093922651933719e-01 1.265843353916152048e-01 1.285342866428339226e-01 1.262593435164120759e-01 1.236594085147871280e-01 1.243093922651933719e-01 1.239844003899902569e-01 1.249593760155996158e-01 1.262593435164120759e-01 1.282092947676308214e-01 1.254468638284042814e-01 1.285342866428339226e-01 1.286967825804354870e-01 1.254468638284042814e-01 1.217094572635684102e-01 1.163470913227169362e-01 1.095222619434514100e-01 1.022099447513812182e-01
1.134221644458888595e-01 1.210594735131621663e-01 1.231719207019824486e-01 1.277218069548261281e-01 1.299967500812479748e-01 1.296717582060448459e-01 1.270718232044198981e-01 1.267468313292167692e-01 1.252843678908027170e-01 1.236594085147871280e-01 1.246343841403964869e-01 1.270718232044198981e-01 1.265843353916152048e-01 1.265843353916152048e-01 1.260968475788105392e-01 1.265843353916152048e-01 1.234969125771855636e-01 1.195970100747481280e-01 1.122846928826779361e-01 1.061098472538186538e-01 1.007474813129671798e-01
1.160220994475138073e-01 1.218719532011699747e-01 1.265843353916152048e-01 1.296717582060448459e-01 1.299967500812479748e-01 1.306467338316542048e-01 1.288592785180370515e-01 1.291842703932401804e-01 1.286967825804354870e-01 1.259343516412089747e-01 1.257718557036074103e-01 1.275593110172245637e-01 1.265843353916152048e-01 1.259343516412089747e-01 1.267468313292167692e-01 1.236594085147871280e-01 1.208969775755606157e-01 1.142346441338966540e-01 1.090347741306467305e-01 1.013974650633734098e-01 9.879753006174846197e-02
1.197595060123496924e-01 1.251218719532011803e-01 1.273968150796229992e-01 1.293467663308417170e-01 1.295092622684432815e-01 1.291842703932401804e-01 1.299967500812479748e-01 1.301592460188495393e-01 1.291842703932401804e-01 1.285342866428339226e-01 1.241468963275918075e-01 1.236594085147871280e-01 1.238219044523886925e-01 1.208969775755606157e-01 1.212219694507637308e-01 1.176470588235294101e-01 1.176470588235294101e-01 1.117972050698732567e-01 1.072473188170295771e-01 9.896002599935001254e-02 9.489762755931101246e-02
1.218719532011699747e-01 1.280467988300292570e-01 1.290217744556386159e-01 1.325966850828729227e-01 1.314592135196619993e-01 1.309717257068573337e-01 1.299967500812479748e-01 1.296717582060448459e-01 1.299967500812479748e-01 1.275593110172245637e-01 1.275593110172245637e-01 1.239844003899902569e-01 1.220344491387715252e-01 1.208969775755606157e-01 1.194345141371465774e-01 1.187845303867403335e-01 1.147221319467013334e-01 1.059473513162170893e-01 1.023724406889827687e-01 9.684757881052973028e-02 8.921026974325642345e-02
1.238219044523886925e-01 1.257718557036074103e-01 1.312967175820604349e-01 1.306467338316542048e-01 1.306467338316542048e-01 1.309717257068573337e-01 1.298342541436464104e-01 1.293467663308417170e-01 1.295092622684432815e-01 1.277218069548261281e-01 1.249593760155996158e-01 1.200844978875528074e-01 1.194345141371465774e-01 1.195970100747481280e-01 1.163470913227169362e-01 1.153721156971075773e-01 1.088722781930451800e-01 1.038349041273968210e-01 9.879753006174846197e-02 9.311017224569385908e-02 8.807279818004550009e-02
1.239844003899902569e-01 1.269093272668183336e-01 1.309717257068573337e-01 1.308092297692557693e-01 1.303217419564510759e-01 1.285342866428339226e-01 1.312967175820604349e-01 1.293467663308417170e-01 1.278843028924276926e-01 1.241468963275918075e-01 1.197595060123496924e-01 1.173220669483262951e-01 1.155346116347091279e-01 1.130971725706857306e-01 1.134221644458888595e-01 1.074098147546311277e-01 1.044848878778030510e-01 9.961000974975625644e-02 9.717257068573285916e-02 9.197270068248293573e-02 8.466038349041274391e-02
1.226844328891777691e-01 1.247968800779980514e-01 1.273968150796229992e-01 1.270718232044198981e-01 1.270718232044198981e-01 1.270718232044198981e-01 1.264218394540136403e-01 1.251218719532011803e-01 1.238219044523886925e-01 1.171595710107247307e-01 1.137471563210919745e-01 1.132596685082872950e-01 1.087097822554436155e-01 1.057848553786155388e-01 1.028599285017874621e-01 9.961000974975625644e-02 9.652258693532661527e-02 9.376015599610010298e-02 8.872278193045174399e-02 8.417289567760806446e-02 7.864803379915502601e-02
1.221969450763730897e-01 1.210594735131621663e-01 1.234969125771855636e-01 1.223594410139746541e-01 1.217094572635684102e-01 1.243093922651933719e-01 1.243093922651933719e-01 1.220344491387715252e-01 1.161845953851153718e-01 1.116347091322716922e-01 1.083847903802405005e-01 1.043223919402015004e-01 9.879753006174846197e-02 9.782255443613910306e-02 9.636009099772505082e-02 9.392265193370165355e-02 9.051023724406889737e-02 8.726031849203770563e-02 8.466038349041274391e-02 7.848553786155346157e-02 7.263568410789730811e-02
