1.164043669360555755e-01 1.179639869559052923e-01 1.178222033177371286e-01 1.182475542322416057e-01 1.139940450871969324e-01 1.086062668368070333e-01 1.081809159223025701e-01 1.039274067772579108e-01 1.019424358429037308e-01 1.037856231390897471e-01 1.063377286261165400e-01 1.103076704948248998e-01 1.186729051467460688e-01 1.242024670353041316e-01 1.298738125620303441e-01 1.321423507727208235e-01 1.358287253650928561e-01 1.371047781086062733e-01 1.379554799376151997e-01 1.371047781086062733e-01 1.334184035162342130e-01
1.147029632780377090e-01 1.190982560612505320e-01 1.200907415284276220e-01 1.192400396994186818e-01 1.175386360414008291e-01 1.108748050474975128e-01 1.087480504749751831e-01 1.084644831986388835e-01 1.061959449879483902e-01 1.077555650077981070e-01 1.101658868566567362e-01 1.152700978307103358e-01 1.237771161207996545e-01 1.300155962001985077e-01 1.339855380689068398e-01 1.369629944704381097e-01 1.382390472139514992e-01 1.383808308521196628e-01 1.388061817666241260e-01 1.402240181483056791e-01 1.358287253650928561e-01
1.175386360414008291e-01 1.188146887849142186e-01 1.215085779101091751e-01 1.219339288246136382e-01 1.182475542322416057e-01 1.125762087055153793e-01 1.101658868566567362e-01 1.105912377711612132e-01 1.070466468169573165e-01 1.104494541329930496e-01 1.138522614490287826e-01 1.232099815681270416e-01 1.270381397986672378e-01 1.352615908124202571e-01 1.368212108322699461e-01 1.406493690628101423e-01 1.412165036154827691e-01 1.430596909116687854e-01 1.423507727208280227e-01 1.426343399971643222e-01 1.396568835956330523e-01
1.148447469162058726e-01 1.202325251665957717e-01 1.216503615482773248e-01 1.256203034169856847e-01 1.234935488444633550e-01 1.181057705940734420e-01 1.124344250673472295e-01 1.128597759818516927e-01 1.120090741528427664e-01 1.141358287253650960e-01 1.182475542322416057e-01 1.253367361406493574e-01 1.318587834963845240e-01 1.373883453849425729e-01 1.409329363391464696e-01 1.416418545299872322e-01 1.429179072735006495e-01 1.450446618460229653e-01 1.475967673330497720e-01 1.444775272933503385e-01 1.395150999574649164e-01
1.135686941726924692e-01 1.164043669360555755e-01 1.215085779101091751e-01 1.237771161207996545e-01 1.212250106337728617e-01 1.190982560612505320e-01 1.176804196795689789e-01 1.137104778108606329e-01 1.131433432581880061e-01 1.144193960017014094e-01 1.190982560612505320e-01 1.249113852261449081e-01 1.329930526017297499e-01 1.393733163192967528e-01 1.429179072735006495e-01 1.449028782078548017e-01 1.460371473132000553e-01 1.478803346093860716e-01 1.470296327803771452e-01 1.453282291223592926e-01 1.397986672338012160e-01
1.117255068765064530e-01 1.138522614490287826e-01 1.179639869559052923e-01 1.171132851268963521e-01 1.182475542322416057e-01 1.158372323833829626e-01 1.137104778108606329e-01 1.142776123635332458e-01 1.132851268963561558e-01 1.156954487452147989e-01 1.205160924429320851e-01 1.283141925421806273e-01 1.307245143910392704e-01 1.363958599177654829e-01 1.385226144902878265e-01 1.424925563589961586e-01 1.440521763788458753e-01 1.474549836948816084e-01 1.444775272933503385e-01 1.439103927406777395e-01 1.373883453849425729e-01
1.076137813696299433e-01 1.132851268963561558e-01 1.182475542322416057e-01 1.179639869559052923e-01 1.176804196795689789e-01 1.162625832978874257e-01 1.135686941726924692e-01 1.154118814688784855e-01 1.141358287253650960e-01 1.161207996597192621e-01 1.189564724230823822e-01 1.266127888841627747e-01 1.318587834963845240e-01 1.358287253650928561e-01 1.402240181483056791e-01 1.433432581880051127e-01 1.441939600170140390e-01 1.457535800368637557e-01 1.450446618460229653e-01 1.440521763788458753e-01 1.380972635757833633e-01
1.037856231390897471e-01 1.094569686658159596e-01 1.166879342123918889e-01 1.173968524032326655e-01 1.161207996597192621e-01 1.148447469162058726e-01 1.156954487452147989e-01 1.130015596200198563e-01 1.135686941726924692e-01 1.152700978307103358e-01 1.186729051467460688e-01 1.256203034169856847e-01 1.302991634765348072e-01 1.356869417269247202e-01 1.375301290231107365e-01 1.405075854246420064e-01 1.417836381681553959e-01 1.447610945696866658e-01 1.440521763788458753e-01 1.429179072735006495e-01 1.406493690628101423e-01
1.026513540337445074e-01 1.097405359421522730e-01 1.154118814688784855e-01 1.188146887849142186e-01 1.183893378704097554e-01 1.175386360414008291e-01 1.175386360414008291e-01 1.173968524032326655e-01 1.199489578902594583e-01 1.220757124627818019e-01 1.236353324826315048e-01 1.266127888841627747e-01 1.295902452856940446e-01 1.344108889834113030e-01 1.356869417269247202e-01 1.396568835956330523e-01 1.388061817666241260e-01 1.419254218063235595e-01 1.427761236353324859e-01 1.439103927406777395e-01 1.372465617467744092e-01
1.052034595207713003e-01 1.100241032184885864e-01 1.169715014887282023e-01 1.195236069757549952e-01 1.212250106337728617e-01 1.216503615482773248e-01 1.212250106337728617e-01 1.219339288246136382e-01 1.226428470154544148e-01 1.243442506734722813e-01 1.266127888841627747e-01 1.295902452856940446e-01 1.331348362398979135e-01 1.365376435559336465e-01 1.369629944704381097e-01 1.400822345101375432e-01 1.415000708918190964e-01 1.417836381681553959e-01 1.409329363391464696e-01 1.422089890826598590e-01 1.339855380689068398e-01
1.076137813696299433e-01 1.155536651070466492e-01 1.185311215085779052e-01 1.227846306536225784e-01 1.236353324826315048e-01 1.225010633772862650e-01 1.251949525024812215e-01 1.254785197788175211e-01 1.256203034169856847e-01 1.247696015879767445e-01 1.268963561604990742e-01 1.301573798383666436e-01 1.348362398979157939e-01 1.335601871544023767e-01 1.375301290231107365e-01 1.382390472139514992e-01 1.399404508719693796e-01 1.416418545299872322e-01 1.406493690628101423e-01 1.386643981284559624e-01 1.302991634765348072e-01
1.128597759818516927e-01 1.189564724230823822e-01 1.267545725223309105e-01 1.294484616475258809e-01 1.277470579895080005e-01 1.285977598185169546e-01 1.301573798383666436e-01 1.290231107330214178e-01 1.285977598185169546e-01 1.302991634765348072e-01 1.288813270948532541e-01 1.335601871544023767e-01 1.344108889834113030e-01 1.358287253650928561e-01 1.376719126612789001e-01 1.371047781086062733e-01 1.400822345101375432e-01 1.402240181483056791e-01 1.403658017864738428e-01 1.337019707925705403e-01 1.253367361406493574e-01
1.152700978307103358e-01 1.233517652062951914e-01 1.297320289238621804e-01 1.352615908124202571e-01 1.329930526017297499e-01 1.312916489437118972e-01 1.324259180490571508e-01 1.308662980292074340e-01 1.327094853253934503e-01 1.314334325818800608e-01 1.310080816673755977e-01 1.335601871544023767e-01 1.346944562597476303e-01 1.371047781086062733e-01 1.373883453849425729e-01 1.369629944704381097e-01 1.365376435559336465e-01 1.373883453849425729e-01 1.339855380689068398e-01 1.288813270948532541e-01 1.200907415284276220e-01
1.205160924429320851e-01 1.260456543314901479e-01 1.325677016872252867e-01 1.368212108322699461e-01 1.400822345101375432e-01 1.376719126612789001e-01 1.376719126612789001e-01 1.352615908124202571e-01 1.346944562597476303e-01 1.348362398979157939e-01 1.348362398979157939e-01 1.342691053452431671e-01 1.355451580887565566e-01 1.378136962994470360e-01 1.375301290231107365e-01 1.363958599177654829e-01 1.324259180490571508e-01 1.331348362398979135e-01 1.318587834963845240e-01 1.259038706933219842e-01 1.151283141925421860e-01
1.271799234368354015e-01 1.321423507727208235e-01 1.368212108322699461e-01 1.419254218063235595e-01 1.458953636750318916e-01 1.406493690628101423e-01 1.393733163192967528e-01 1.378136962994470360e-01 1.361122926414291834e-01 1.338437544307387039e-01 1.315752162200481967e-01 1.339855380689068398e-01 1.351198071742520934e-01 1.363958599177654829e-01 1.351198071742520934e-01 1.349780235360839298e-01 1.304409471147029709e-01 1.308662980292074340e-01 1.308662980292074340e-01 1.236353324826315048e-01 1.171132851268963521e-01
1.295902452856940446e-01 1.352615908124202571e-01 1.371047781086062733e-01 1.433432581880051127e-01 1.441939600170140390e-01 1.422089890826598590e-01 1.399404508719693796e-01 1.373883453849425729e-01 1.369629944704381097e-01 1.342691053452431671e-01 1.324259180490571508e-01 1.335601871544023767e-01 1.327094853253934503e-01 1.361122926414291834e-01 1.348362398979157939e-01 1.338437544307387039e-01 1.297320289238621804e-01 1.321423507727208235e-01 1.304409471147029709e-01 1.229264142917907282e-01 1.135686941726924692e-01
1.310080816673755977e-01 1.325677016872252867e-01 1.390897490429604533e-01 1.410747199773146054e-01 1.422089890826598590e-01 1.407911527009783059e-01 1.427761236353324859e-01 1.397986672338012160e-01 1.365376435559336465e-01 1.338437544307387039e-01 1.322841344108889872e-01 1.335601871544023767e-01 1.342691053452431671e-01 1.355451580887565566e-01 1.334184035162342130e-01 1.327094853253934503e-01 1.302991634765348072e-01 1.322841344108889872e-01 1.264710052459946110e-01 1.210832269956047119e-01 1.124344250673472295e-01
1.297320289238621804e-01 1.332766198780660771e-01 1.389479654047922896e-01 1.413582872536509327e-01 1.407911527009783059e-01 1.426343399971643222e-01 1.407911527009783059e-01 1.372465617467744092e-01 1.341273217070750035e-01 1.310080816673755977e-01 1.295902452856940446e-01 1.328512689635616140e-01 1.361122926414291834e-01 1.348362398979157939e-01 1.281724089040124637e-01 1.280306252658443278e-01 1.267545725223309105e-01 1.270381397986672378e-01 1.254785197788175211e-01 1.182475542322416057e-01 1.120090741528427664e-01
1.311498653055437336e-01 1.349780235360839298e-01 1.378136962994470360e-01 1.388061817666241260e-01 1.406493690628101423e-01 1.399404508719693796e-01 1.388061817666241260e-01 1.338437544307387039e-01 1.341273217070750035e-01 1.318587834963845240e-01 1.264710052459946110e-01 1.288813270948532541e-01 1.308662980292074340e-01 1.293066780093577173e-01 1.234935488444633550e-01 1.247696015879767445e-01 1.225010633772862650e-01 1.212250106337728617e-01 1.198071742520913086e-01 1.164043669360555755e-01 1.050616758826031505e-01
1.273217070750035373e-01 1.307245143910392704e-01 1.344108889834113030e-01 1.358287253650928561e-01 1.361122926414291834e-01 1.365376435559336465e-01 1.348362398979157939e-01 1.315752162200481967e-01 1.300155962001985077e-01 1.283141925421806273e-01 1.244860343116404311e-01 1.244860343116404311e-01 1.244860343116404311e-01 1.216503615482773248e-01 1.203743088047639354e-01 1.199489578902594583e-01 1.158372323833829626e-01 1.149865305543740224e-01 1.121508577910109161e-01 1.073302140932936299e-01 1.018006522047355672e-01
1.250531688643130579e-01 1.278888416276761641e-01 1.322841344108889872e-01 1.329930526017297499e-01 1.338437544307387039e-01 1.288813270948532541e-01 1.284559761803487909e-01 1.259038706933219842e-01 1.243442506734722813e-01 1.215085779101091751e-01 1.189564724230823822e-01 1.175386360414008291e-01 1.179639869559052923e-01 1.161207996597192621e-01 1.135686941726924692e-01 1.132851268963561558e-01 1.088898341131433467e-01 1.074719977314617936e-01 1.046363249680986873e-01 1.040691904154260605e-01 9.683822486885013126e-02
