1.125338142470694303e-01 1.157799819657348989e-01 1.155996393146979245e-01 1.150586113615870154e-01 1.121731289449954955e-01 1.074842200180342600e-01 1.047790802524797144e-01 1.033363390441839474e-01 9.792605951307484236e-02 9.540126239855725720e-02 1.002705139765554532e-01 1.049594229035166748e-01 1.110910730387736634e-01 1.154192966636609502e-01 1.210099188458070296e-01 1.262398557258791743e-01 1.282236248872858364e-01 1.280432822362488621e-01 1.271415689810640182e-01 1.262398557258791743e-01 1.222723174030658222e-01
1.114517583408476120e-01 1.132551848512173137e-01 1.146979260595130806e-01 1.148782687105500411e-01 1.146979260595130806e-01 1.121731289449954955e-01 1.119927862939585211e-01 1.105500450856627542e-01 1.058611361587015326e-01 1.022542831379621292e-01 1.045987376014427400e-01 1.098286744815148847e-01 1.155996393146979245e-01 1.208295761947700692e-01 1.273219116321009925e-01 1.312894499549143446e-01 1.318304779080252398e-01 1.321911632100991885e-01 1.296663660955816033e-01 1.273219116321009925e-01 1.219116321009918874e-01
1.087466185752930525e-01 1.137962128043282228e-01 1.161406672678088337e-01 1.165013525698827823e-01 1.190261496844003675e-01 1.177637511271415749e-01 1.179440937781785353e-01 1.145175834084761063e-01 1.132551848512173137e-01 1.121731289449954955e-01 1.127141568981064046e-01 1.174030658250676262e-01 1.208295761947700692e-01 1.264201983769161486e-01 1.311091073038773702e-01 1.347159603246167736e-01 1.366997294860234358e-01 1.343552750225428249e-01 1.321911632100991885e-01 1.291253381424707081e-01 1.247971145175834073e-01
1.082055906221821434e-01 1.110910730387736634e-01 1.157799819657348989e-01 1.172227231740306519e-01 1.188458070333633931e-01 1.155996393146979245e-01 1.181244364292155097e-01 1.220919747520288617e-01 1.170423805229936914e-01 1.186654643823264188e-01 1.201082055906221857e-01 1.219116321009918874e-01 1.269612263300270438e-01 1.336339044183949554e-01 1.359783588818755662e-01 1.408476104598737622e-01 1.381424706943192027e-01 1.356176735798016175e-01 1.350766456266907223e-01 1.312894499549143446e-01 1.255184851217312769e-01
1.060414788097385069e-01 1.094679891794409360e-01 1.172227231740306519e-01 1.175834084761046006e-01 1.193868349864743023e-01 1.206492335437330948e-01 1.215509467989179387e-01 1.224526600541027965e-01 1.202885482416591462e-01 1.202885482416591462e-01 1.213706041478809783e-01 1.273219116321009925e-01 1.320108205590622141e-01 1.379621280432822283e-01 1.403065825067628392e-01 1.379621280432822283e-01 1.376014427412083074e-01 1.374211000901713331e-01 1.341749323715058506e-01 1.314697926059513189e-01 1.276825969341749412e-01
1.051397655545536491e-01 1.100090171325518451e-01 1.152389540126239897e-01 1.186654643823264188e-01 1.213706041478809783e-01 1.204688908926961205e-01 1.244364292155094726e-01 1.249774571686203817e-01 1.206492335437330948e-01 1.201082055906221857e-01 1.235347159603246148e-01 1.249774571686203817e-01 1.332732191163210067e-01 1.408476104598737622e-01 1.399458972046889182e-01 1.404869251577998135e-01 1.403065825067628392e-01 1.404869251577998135e-01 1.363390441839495149e-01 1.338142470694319297e-01 1.298467087466185776e-01
1.047790802524797144e-01 1.060414788097385069e-01 1.092876465284039617e-01 1.148782687105500411e-01 1.202885482416591462e-01 1.190261496844003675e-01 1.237150586113615891e-01 1.242560865644724982e-01 1.231740306582506800e-01 1.222723174030658222e-01 1.235347159603246148e-01 1.228133453561767313e-01 1.302073940486925263e-01 1.365193868349864614e-01 1.394048692515779952e-01 1.394048692515779952e-01 1.392245266005410209e-01 1.422903516681695291e-01 1.386834986474301257e-01 1.365193868349864614e-01 1.296663660955816033e-01
9.774571686203786802e-02 1.036970243462578961e-01 1.094679891794409360e-01 1.130748422001803394e-01 1.188458070333633931e-01 1.190261496844003675e-01 1.201082055906221857e-01 1.199278629395852114e-01 1.208295761947700692e-01 1.210099188458070296e-01 1.226330027051397709e-01 1.240757439134355239e-01 1.284039675383228107e-01 1.338142470694319297e-01 1.376014427412083074e-01 1.381424706943192027e-01 1.379621280432822283e-01 1.406672678088367878e-01 1.403065825067628392e-01 1.361587015329125405e-01 1.287646528403967594e-01
9.630297565374211499e-02 1.008115419296663623e-01 1.058611361587015326e-01 1.152389540126239897e-01 1.211902614968440040e-01 1.188458070333633931e-01 1.222723174030658222e-01 1.219116321009918874e-01 1.202885482416591462e-01 1.183047790802524840e-01 1.220919747520288617e-01 1.240757439134355239e-01 1.260595130748421999e-01 1.302073940486925263e-01 1.334535617673579810e-01 1.361587015329125405e-01 1.357980162308385919e-01 1.374211000901713331e-01 1.350766456266907223e-01 1.320108205590622141e-01 1.269612263300270438e-01
9.287646528403967205e-02 1.022542831379621292e-01 1.064021641118124417e-01 1.132551848512173137e-01 1.193868349864743023e-01 1.213706041478809783e-01 1.253381424706943303e-01 1.246167718665464330e-01 1.204688908926961205e-01 1.175834084761046006e-01 1.201082055906221857e-01 1.231740306582506800e-01 1.256988277727682513e-01 1.289449954914337337e-01 1.302073940486925263e-01 1.332732191163210067e-01 1.323715058611361628e-01 1.354373309287646432e-01 1.350766456266907223e-01 1.316501352569882655e-01 1.204688908926961205e-01
9.215509467989178860e-02 9.864743011722272581e-02 1.080252479711451691e-01 1.112714156898106377e-01 1.210099188458070296e-01 1.238954012623985634e-01 1.266005410279531229e-01 1.267808836789900695e-01 1.208295761947700692e-01 1.186654643823264188e-01 1.201082055906221857e-01 1.201082055906221857e-01 1.231740306582506800e-01 1.264201983769161486e-01 1.271415689810640182e-01 1.284039675383228107e-01 1.302073940486925263e-01 1.348963029756537479e-01 1.332732191163210067e-01 1.251577998196573560e-01 1.170423805229936914e-01
9.756537421100090757e-02 1.022542831379621292e-01 1.076645626690712343e-01 1.184851217312894445e-01 1.228133453561767313e-01 1.269612263300270438e-01 1.318304779080252398e-01 1.271415689810640182e-01 1.247971145175834073e-01 1.226330027051397709e-01 1.208295761947700692e-01 1.202885482416591462e-01 1.222723174030658222e-01 1.237150586113615891e-01 1.237150586113615891e-01 1.246167718665464330e-01 1.287646528403967594e-01 1.303877366997294729e-01 1.258791704238052256e-01 1.195671776375112766e-01 1.109107303877367029e-01
1.009918845807033366e-01 1.067628494138863904e-01 1.155996393146979245e-01 1.220919747520288617e-01 1.247971145175834073e-01 1.293056807935076546e-01 1.312894499549143446e-01 1.287646528403967594e-01 1.264201983769161486e-01 1.226330027051397709e-01 1.219116321009918874e-01 1.192064923354373279e-01 1.206492335437330948e-01 1.210099188458070296e-01 1.228133453561767313e-01 1.249774571686203817e-01 1.251577998196573560e-01 1.275022542831379668e-01 1.226330027051397709e-01 1.183047790802524840e-01 1.094679891794409360e-01
1.109107303877367029e-01 1.159603246167718732e-01 1.220919747520288617e-01 1.255184851217312769e-01 1.309287646528403959e-01 1.309287646528403959e-01 1.320108205590622141e-01 1.280432822362488621e-01 1.264201983769161486e-01 1.237150586113615891e-01 1.235347159603246148e-01 1.219116321009918874e-01 1.202885482416591462e-01 1.215509467989179387e-01 1.229936880072137056e-01 1.262398557258791743e-01 1.255184851217312769e-01 1.251577998196573560e-01 1.215509467989179387e-01 1.166816952209197428e-01 1.062218214607754674e-01
1.174030658250676262e-01 1.184851217312894445e-01 1.229936880072137056e-01 1.294860234445446290e-01 1.312894499549143446e-01 1.330928764652840324e-01 1.309287646528403959e-01 1.316501352569882655e-01 1.289449954914337337e-01 1.255184851217312769e-01 1.249774571686203817e-01 1.249774571686203817e-01 1.228133453561767313e-01 1.211902614968440040e-01 1.264201983769161486e-01 1.246167718665464330e-01 1.266005410279531229e-01 1.275022542831379668e-01 1.235347159603246148e-01 1.161406672678088337e-01 1.067628494138863904e-01
1.186654643823264188e-01 1.231740306582506800e-01 1.305680793507664472e-01 1.321911632100991885e-01 1.343552750225428249e-01 1.350766456266907223e-01 1.379621280432822283e-01 1.334535617673579810e-01 1.336339044183949554e-01 1.327321911632101115e-01 1.293056807935076546e-01 1.296663660955816033e-01 1.266005410279531229e-01 1.267808836789900695e-01 1.280432822362488621e-01 1.294860234445446290e-01 1.287646528403967594e-01 1.253381424706943303e-01 1.251577998196573560e-01 1.179440937781785353e-01 1.085662759242560921e-01
1.213706041478809783e-01 1.246167718665464330e-01 1.312894499549143446e-01 1.345356176735797993e-01 1.348963029756537479e-01 1.388638412984671000e-01 1.376014427412083074e-01 1.347159603246167736e-01 1.314697926059513189e-01 1.316501352569882655e-01 1.296663660955816033e-01 1.271415689810640182e-01 1.260595130748421999e-01 1.269612263300270438e-01 1.271415689810640182e-01 1.298467087466185776e-01 1.293056807935076546e-01 1.253381424706943303e-01 1.217312894499549131e-01 1.159603246167718732e-01 1.062218214607754674e-01
1.233543733092876404e-01 1.255184851217312769e-01 1.320108205590622141e-01 1.330928764652840324e-01 1.363390441839495149e-01 1.394048692515779952e-01 1.377817853922452540e-01 1.350766456266907223e-01 1.330928764652840324e-01 1.334535617673579810e-01 1.329125338142470580e-01 1.275022542831379668e-01 1.264201983769161486e-01 1.247971145175834073e-01 1.258791704238052256e-01 1.276825969341749412e-01 1.278629395852119155e-01 1.242560865644724982e-01 1.201082055906221857e-01 1.134355275022542880e-01 1.042380522993688052e-01
1.206492335437330948e-01 1.256988277727682513e-01 1.298467087466185776e-01 1.325518485121731371e-01 1.365193868349864614e-01 1.361587015329125405e-01 1.379621280432822283e-01 1.352569882777276689e-01 1.345356176735797993e-01 1.325518485121731371e-01 1.285843101893597851e-01 1.276825969341749412e-01 1.251577998196573560e-01 1.213706041478809783e-01 1.215509467989179387e-01 1.220919747520288617e-01 1.231740306582506800e-01 1.219116321009918874e-01 1.175834084761046006e-01 1.118124436429215468e-01 1.002705139765554532e-01
1.188458070333633931e-01 1.237150586113615891e-01 1.287646528403967594e-01 1.327321911632101115e-01 1.332732191163210067e-01 1.341749323715058506e-01 1.343552750225428249e-01 1.321911632100991885e-01 1.323715058611361628e-01 1.285843101893597851e-01 1.256988277727682513e-01 1.228133453561767313e-01 1.199278629395852114e-01 1.174030658250676262e-01 1.166816952209197428e-01 1.179440937781785353e-01 1.188458070333633931e-01 1.186654643823264188e-01 1.125338142470694303e-01 1.024346257889991035e-01 9.413886384129846463e-02
1.130748422001803394e-01 1.190261496844003675e-01 1.226330027051397709e-01 1.273219116321009925e-01 1.316501352569882655e-01 1.309287646528403959e-01 1.307484220018034216e-01 1.285843101893597851e-01 1.291253381424707081e-01 1.242560865644724982e-01 1.181244364292155097e-01 1.148782687105500411e-01 1.165013525698827823e-01 1.130748422001803394e-01 1.118124436429215468e-01 1.130748422001803394e-01 1.103697024346257938e-01 1.080252479711451691e-01 9.882777276825970014e-02 9.413886384129846463e-02 8.710550045085663218e-02
