1.176470588235294101e-01 1.198307629316227585e-01 1.157363177289477268e-01 1.089122423911560028e-01 1.070015012965743195e-01 1.033165006141667785e-01 9.744779582366588921e-02 9.362631363450252264e-02 9.308038760747919249e-02 9.567353623584004541e-02 9.826668486420089832e-02 1.035894636276784436e-01 1.110959464992493512e-01 1.172376143032619056e-01 1.236522451207861389e-01 1.251535416951003177e-01 1.302033574450661979e-01 1.318411355261362161e-01 1.322505800464037207e-01 1.300668759383103723e-01 1.261089122423911524e-01
1.184659478640644192e-01 1.236522451207861389e-01 1.194213184113552678e-01 1.172376143032619056e-01 1.139620581411218830e-01 1.075474273235976497e-01 1.042718711614576271e-01 1.012692780128292558e-01 9.867612938446840287e-02 1.015422410263409347e-01 1.039989081479459482e-01 1.110959464992493512e-01 1.172376143032619056e-01 1.221509485464719463e-01 1.265183567626586569e-01 1.318411355261362161e-01 1.321140985396478673e-01 1.355261362085437293e-01 1.337518766207178855e-01 1.333424321004503810e-01 1.307492834720895281e-01
1.196942814248669329e-01 1.232428006005186344e-01 1.236522451207861389e-01 1.214685410126927767e-01 1.190118738910877633e-01 1.116418725262726952e-01 1.063190937627951360e-01 1.070015012965743195e-01 1.064555752695509755e-01 1.057731677357718059e-01 1.091852054046676679e-01 1.145079841681452132e-01 1.209226149856694466e-01 1.261089122423911524e-01 1.288385423775078586e-01 1.296574314180428678e-01 1.336153951139620599e-01 1.382557663436604356e-01 1.352531731950320781e-01 1.345707656612528946e-01 1.315681725126245372e-01
1.149174286884127177e-01 1.222874300532277858e-01 1.247440971748328131e-01 1.224239115599836253e-01 1.210590964924252722e-01 1.125972430735635299e-01 1.095946499249351724e-01 1.064555752695509755e-01 1.083663163641326588e-01 1.091852054046676679e-01 1.112324280060051906e-01 1.165552067694827360e-01 1.201037259451344374e-01 1.250170601883444921e-01 1.300668759383103723e-01 1.304763204585778491e-01 1.330694690869387298e-01 1.362085437423229128e-01 1.362085437423229128e-01 1.347072471680087480e-01 1.332059505936945554e-01
1.104135389654701815e-01 1.180565033437969147e-01 1.217415040262044557e-01 1.233792821072744600e-01 1.196942814248669329e-01 1.134161321140985390e-01 1.124607615668077043e-01 1.105500204722260071e-01 1.100040944452026770e-01 1.105500204722260071e-01 1.153268732086802223e-01 1.171011327965060800e-01 1.203766889586461025e-01 1.237887266275419645e-01 1.276102088167053450e-01 1.319776170328920417e-01 1.338883581274737389e-01 1.349802101815203992e-01 1.356626177152995827e-01 1.342978026477412434e-01 1.323870615531595463e-01
1.068650197898184800e-01 1.125972430735635299e-01 1.180565033437969147e-01 1.181929848505527542e-01 1.171011327965060800e-01 1.128702060870751950e-01 1.116418725262726952e-01 1.105500204722260071e-01 1.125972430735635299e-01 1.128702060870751950e-01 1.139620581411218830e-01 1.161457622492152314e-01 1.179200218370410752e-01 1.198307629316227585e-01 1.258359492288794734e-01 1.299303944315545190e-01 1.315681725126245372e-01 1.329329875801828764e-01 1.344342841544970690e-01 1.308857649788453537e-01 1.300668759383103723e-01
1.039989081479459482e-01 1.100040944452026770e-01 1.135526136208543785e-01 1.146444656749010527e-01 1.158727992357035663e-01 1.109594649924935117e-01 1.109594649924935117e-01 1.102770574587143421e-01 1.120513170465401998e-01 1.115053910195168557e-01 1.125972430735635299e-01 1.146444656749010527e-01 1.162822437559710709e-01 1.190118738910877633e-01 1.250170601883444921e-01 1.277466903234611706e-01 1.303398389518220235e-01 1.314316910058687116e-01 1.332059505936945554e-01 1.281561348437286751e-01 1.255629862153678222e-01
1.005868704790500862e-01 1.065920567763068150e-01 1.095946499249351724e-01 1.139620581411218830e-01 1.132796506073426995e-01 1.113689095127610162e-01 1.115053910195168557e-01 1.093216869114235074e-01 1.106865019789818466e-01 1.106865019789818466e-01 1.102770574587143421e-01 1.134161321140985390e-01 1.154633547154360618e-01 1.198307629316227585e-01 1.213320595059369511e-01 1.261089122423911524e-01 1.299303944315545190e-01 1.287020608707520053e-01 1.274737273099494916e-01 1.235157636140302995e-01 1.195577999181110934e-01
1.004503889722942606e-01 1.059096492425276315e-01 1.068650197898184800e-01 1.117783540330285208e-01 1.124607615668077043e-01 1.130066875938310345e-01 1.143715026613893876e-01 1.124607615668077043e-01 1.123242800600518648e-01 1.113689095127610162e-01 1.117783540330285208e-01 1.115053910195168557e-01 1.150539101951685572e-01 1.180565033437969147e-01 1.206496519721577676e-01 1.231063190937627949e-01 1.265183567626586569e-01 1.250170601883444921e-01 1.233792821072744600e-01 1.195577999181110934e-01 1.147809471816568921e-01
1.011327965060734302e-01 1.061826122560393104e-01 1.094581684181793330e-01 1.130066875938310345e-01 1.150539101951685572e-01 1.158727992357035663e-01 1.149174286884127177e-01 1.154633547154360618e-01 1.132796506073426995e-01 1.125972430735635299e-01 1.113689095127610162e-01 1.128702060870751950e-01 1.145079841681452132e-01 1.176470588235294101e-01 1.225603930667394509e-01 1.228333560802511298e-01 1.239252081342978040e-01 1.226968745734952904e-01 1.209226149856694466e-01 1.169646512897502405e-01 1.101405759519585165e-01
1.008598334925617512e-01 1.067285382830626406e-01 1.157363177289477268e-01 1.165552067694827360e-01 1.186024293708202587e-01 1.160092807424593919e-01 1.149174286884127177e-01 1.150539101951685572e-01 1.147809471816568921e-01 1.125972430735635299e-01 1.117783540330285208e-01 1.116418725262726952e-01 1.136890951276102041e-01 1.164187252627268965e-01 1.199672444383785980e-01 1.181929848505527542e-01 1.205131704654019420e-01 1.190118738910877633e-01 1.145079841681452132e-01 1.105500204722260071e-01 1.050907602019926362e-01
1.029070560938992740e-01 1.106865019789818466e-01 1.162822437559710709e-01 1.180565033437969147e-01 1.192848369045994283e-01 1.183294663573085798e-01 1.146444656749010527e-01 1.155998362221918874e-01 1.138255766343660436e-01 1.125972430735635299e-01 1.130066875938310345e-01 1.130066875938310345e-01 1.165552067694827360e-01 1.168281697829944010e-01 1.180565033437969147e-01 1.187389108775760843e-01 1.198307629316227585e-01 1.171011327965060800e-01 1.131431691005868739e-01 1.083663163641326588e-01 1.033165006141667785e-01
1.085027978708884983e-01 1.149174286884127177e-01 1.207861334789136071e-01 1.211955779991811116e-01 1.222874300532277858e-01 1.205131704654019420e-01 1.186024293708202587e-01 1.166916882762385754e-01 1.147809471816568921e-01 1.140985396478777086e-01 1.125972430735635299e-01 1.138255766343660436e-01 1.136890951276102041e-01 1.175105773167735707e-01 1.187389108775760843e-01 1.190118738910877633e-01 1.203766889586461025e-01 1.194213184113552678e-01 1.160092807424593919e-01 1.083663163641326588e-01 1.024976115736317694e-01
1.121877985532960254e-01 1.172376143032619056e-01 1.198307629316227585e-01 1.228333560802511298e-01 1.232428006005186344e-01 1.205131704654019420e-01 1.187389108775760843e-01 1.176470588235294101e-01 1.143715026613893876e-01 1.157363177289477268e-01 1.143715026613893876e-01 1.157363177289477268e-01 1.138255766343660436e-01 1.175105773167735707e-01 1.181929848505527542e-01 1.202402074518902630e-01 1.210590964924252722e-01 1.216050225194486162e-01 1.181929848505527542e-01 1.121877985532960254e-01 1.063190937627951360e-01
1.184659478640644192e-01 1.247440971748328131e-01 1.262453937491469780e-01 1.277466903234611706e-01 1.292479868977753632e-01 1.273372458031936660e-01 1.246076156680769736e-01 1.233792821072744600e-01 1.188753923843319238e-01 1.187389108775760843e-01 1.172376143032619056e-01 1.181929848505527542e-01 1.165552067694827360e-01 1.168281697829944010e-01 1.199672444383785980e-01 1.246076156680769736e-01 1.263818752559028313e-01 1.250170601883444921e-01 1.229698375870069554e-01 1.164187252627268965e-01 1.100040944452026770e-01
1.218779855329602813e-01 1.244711341613211342e-01 1.303398389518220235e-01 1.315681725126245372e-01 1.295209499112870144e-01 1.280196533369728495e-01 1.266548382694144825e-01 1.256994677221236478e-01 1.203766889586461025e-01 1.195577999181110934e-01 1.172376143032619056e-01 1.173740958100177451e-01 1.173740958100177451e-01 1.194213184113552678e-01 1.214685410126927767e-01 1.256994677221236478e-01 1.292479868977753632e-01 1.276102088167053450e-01 1.263818752559028313e-01 1.190118738910877633e-01 1.113689095127610162e-01
1.247440971748328131e-01 1.274737273099494916e-01 1.315681725126245372e-01 1.327965060734270508e-01 1.296574314180428678e-01 1.289750238842636842e-01 1.289750238842636842e-01 1.261089122423911524e-01 1.217415040262044557e-01 1.199672444383785980e-01 1.176470588235294101e-01 1.169646512897502405e-01 1.181929848505527542e-01 1.225603930667394509e-01 1.258359492288794734e-01 1.281561348437286751e-01 1.312952094991128582e-01 1.319776170328920417e-01 1.302033574450661979e-01 1.221509485464719463e-01 1.155998362221918874e-01
1.269278012829261615e-01 1.295209499112870144e-01 1.307492834720895281e-01 1.311587279923570326e-01 1.322505800464037207e-01 1.303398389518220235e-01 1.266548382694144825e-01 1.265183567626586569e-01 1.255629862153678222e-01 1.228333560802511298e-01 1.205131704654019420e-01 1.217415040262044557e-01 1.199672444383785980e-01 1.225603930667394509e-01 1.289750238842636842e-01 1.281561348437286751e-01 1.314316910058687116e-01 1.332059505936945554e-01 1.287020608707520053e-01 1.236522451207861389e-01 1.143715026613893876e-01
1.273372458031936660e-01 1.295209499112870144e-01 1.310222464856012070e-01 1.310222464856012070e-01 1.297939129247986934e-01 1.272007642964378404e-01 1.270642827896819871e-01 1.254265047086119966e-01 1.255629862153678222e-01 1.224239115599836253e-01 1.184659478640644192e-01 1.190118738910877633e-01 1.201037259451344374e-01 1.202402074518902630e-01 1.239252081342978040e-01 1.262453937491469780e-01 1.291115053910195098e-01 1.304763204585778491e-01 1.277466903234611706e-01 1.237887266275419645e-01 1.158727992357035663e-01
1.277466903234611706e-01 1.302033574450661979e-01 1.306128019653337025e-01 1.293844684045311888e-01 1.285655793639961797e-01 1.258359492288794734e-01 1.237887266275419645e-01 1.222874300532277858e-01 1.207861334789136071e-01 1.181929848505527542e-01 1.147809471816568921e-01 1.154633547154360618e-01 1.153268732086802223e-01 1.175105773167735707e-01 1.187389108775760843e-01 1.199672444383785980e-01 1.229698375870069554e-01 1.252900232018561433e-01 1.265183567626586569e-01 1.210590964924252722e-01 1.134161321140985390e-01
1.235157636140302995e-01 1.269278012829261615e-01 1.287020608707520053e-01 1.280196533369728495e-01 1.262453937491469780e-01 1.237887266275419645e-01 1.205131704654019420e-01 1.155998362221918874e-01 1.158727992357035663e-01 1.124607615668077043e-01 1.100040944452026770e-01 1.106865019789818466e-01 1.108229834857376861e-01 1.116418725262726952e-01 1.139620581411218830e-01 1.158727992357035663e-01 1.198307629316227585e-01 1.202402074518902630e-01 1.166916882762385754e-01 1.151903917019243828e-01 1.093216869114235074e-01
