9.936073059360731041e-02 9.735159817351597689e-02 9.607305936073060049e-02 9.406392694063926696e-02 9.534246575342465724e-02 9.442922374429223165e-02 9.552511415525113958e-02 9.789954337899543779e-02 9.972602739726027510e-02 1.073972602739726029e-01 1.094063926940639225e-01 1.123287671232876678e-01 1.134246575342465757e-01 1.128767123287671287e-01 1.141552511415525051e-01 1.183561643835616406e-01 1.165296803652968033e-01 1.170776255707762503e-01 1.178082191780821936e-01 1.179908675799086759e-01 1.176255707762557112e-01
9.954337899543379276e-02 9.863013698630136716e-02 9.863013698630136716e-02 9.552511415525113958e-02 9.607305936073060049e-02 9.607305936073060049e-02 9.936073059360731041e-02 1.008219178082191830e-01 1.039269406392694106e-01 1.114155251141552561e-01 1.161643835616438386e-01 1.181735159817351583e-01 1.216438356164383505e-01 1.198173515981735132e-01 1.187214611872146053e-01 1.251141552511415567e-01 1.251141552511415567e-01 1.251141552511415567e-01 1.249315068493150743e-01 1.240182648401826487e-01 1.205479452054794565e-01
1.015525114155251124e-01 1.026484018264840203e-01 1.022831050228310557e-01 9.917808219178082807e-02 1.022831050228310557e-01 9.936073059360731041e-02 1.039269406392694106e-01 1.079452054794520499e-01 1.108675799086757952e-01 1.176255707762557112e-01 1.210958904109589035e-01 1.242009132420091311e-01 1.234703196347032017e-01 1.251141552511415567e-01 1.260273972602739823e-01 1.305936073059360825e-01 1.316894977168949765e-01 1.307762557077625509e-01 1.304109589041095862e-01 1.284018264840182666e-01 1.256621004566210176e-01
1.013698630136986301e-01 9.972602739726027510e-02 1.006392694063927007e-01 9.826484018264840248e-02 1.017351598173515947e-01 9.972602739726027510e-02 1.030136986301369850e-01 1.097716894977169011e-01 1.130593607305936110e-01 1.199999999999999956e-01 1.236529680365296840e-01 1.265753424657534154e-01 1.258447488584474860e-01 1.291324200913241960e-01 1.280365296803653019e-01 1.324200913242009059e-01 1.362557077625570767e-01 1.347945205479452180e-01 1.347945205479452180e-01 1.344292237442922255e-01 1.307762557077625509e-01
1.000913242009132398e-01 1.024657534246575380e-01 1.033789954337899497e-01 1.006392694063927007e-01 1.026484018264840203e-01 1.035616438356164321e-01 1.063013698630136949e-01 1.070319634703196382e-01 1.161643835616438386e-01 1.210958904109589035e-01 1.256621004566210176e-01 1.267579908675799116e-01 1.276712328767123372e-01 1.293150684931506922e-01 1.291324200913241960e-01 1.340639269406392609e-01 1.375342465753424670e-01 1.397260273972602829e-01 1.368036529680365376e-01 1.329680365296803668e-01 1.311415525114155156e-01
1.006392694063927007e-01 1.019178082191780771e-01 1.037442922374429283e-01 1.024657534246575380e-01 1.053881278538812832e-01 1.061187214611872126e-01 1.072146118721461205e-01 1.103196347031963481e-01 1.190867579908675838e-01 1.223744292237442938e-01 1.265753424657534154e-01 1.293150684931506922e-01 1.302283105022831178e-01 1.291324200913241960e-01 1.331506849315068630e-01 1.338812785388127924e-01 1.378995433789954317e-01 1.393607305936073182e-01 1.384474885844748926e-01 1.357077625570776158e-01 1.300456621004566216e-01
1.010045662100456654e-01 1.048401826484018223e-01 1.072146118721461205e-01 1.063013698630136949e-01 1.086757990867579932e-01 1.086757990867579932e-01 1.117808219178082207e-01 1.132420091324200934e-01 1.185388127853881229e-01 1.251141552511415567e-01 1.274885844748858410e-01 1.276712328767123372e-01 1.318721461187214727e-01 1.373515981735159708e-01 1.369863013698630061e-01 1.371689497716895023e-01 1.408219178082191769e-01 1.406392694063926807e-01 1.410045662100456731e-01 1.353424657534246511e-01 1.318721461187214727e-01
1.039269406392694106e-01 1.079452054794520499e-01 1.084931506849315108e-01 1.083105022831050285e-01 1.073972602739726029e-01 1.066666666666666735e-01 1.110502283105022775e-01 1.154337899543378954e-01 1.196347031963470309e-01 1.260273972602739823e-01 1.276712328767123372e-01 1.309589041095890471e-01 1.326027397260274021e-01 1.351598173515981827e-01 1.364383561643835729e-01 1.382648401826483964e-01 1.413698630136986378e-01 1.435616438356164259e-01 1.393607305936073182e-01 1.336986301369862962e-01 1.313242009132420118e-01
1.048401826484018223e-01 1.106849315068493128e-01 1.106849315068493128e-01 1.112328767123287737e-01 1.119634703196347031e-01 1.139726027397260227e-01 1.165296803652968033e-01 1.179908675799086759e-01 1.236529680365296840e-01 1.285844748858447351e-01 1.316894977168949765e-01 1.344292237442922255e-01 1.353424657534246511e-01 1.389954337899543257e-01 1.397260273972602829e-01 1.417351598173516025e-01 1.410045662100456731e-01 1.431963470319634613e-01 1.442922374429223831e-01 1.382648401826483964e-01 1.315068493150684803e-01
1.068493150684931559e-01 1.121461187214611854e-01 1.157990867579908739e-01 1.157990867579908739e-01 1.176255707762557112e-01 1.196347031963470309e-01 1.207305936073059388e-01 1.231050228310502231e-01 1.263926940639269469e-01 1.289497716894977275e-01 1.342465753424657571e-01 1.349771689497716864e-01 1.402739726027397160e-01 1.391780821917808220e-01 1.419178082191780710e-01 1.419178082191780710e-01 1.433789954337899575e-01 1.441095890410958869e-01 1.437442922374429222e-01 1.402739726027397160e-01 1.344292237442922255e-01
1.073972602739726029e-01 1.141552511415525051e-01 1.194520547945205485e-01 1.199999999999999956e-01 1.220091324200913291e-01 1.243835616438356134e-01 1.260273972602739823e-01 1.240182648401826487e-01 1.300456621004566216e-01 1.322374429223744374e-01 1.362557077625570767e-01 1.380821917808219279e-01 1.408219178082191769e-01 1.408219178082191769e-01 1.433789954337899575e-01 1.450228310502283124e-01 1.437442922374429222e-01 1.435616438356164259e-01 1.455707762557077734e-01 1.411872146118721416e-01 1.344292237442922255e-01
1.097716894977169011e-01 1.185388127853881229e-01 1.236529680365296840e-01 1.231050228310502231e-01 1.242009132420091311e-01 1.280365296803653019e-01 1.300456621004566216e-01 1.271232876712328763e-01 1.309589041095890471e-01 1.336986301369862962e-01 1.368036529680365376e-01 1.402739726027397160e-01 1.426484018264840281e-01 1.404566210045662122e-01 1.411872146118721416e-01 1.446575342465753478e-01 1.455707762557077734e-01 1.422831050228310634e-01 1.388127853881278573e-01 1.411872146118721416e-01 1.340639269406392609e-01
1.112328767123287737e-01 1.176255707762557112e-01 1.225570776255707761e-01 1.256621004566210176e-01 1.262100456621004507e-01 1.271232876712328763e-01 1.280365296803653019e-01 1.298630136986301253e-01 1.309589041095890471e-01 1.360730593607305805e-01 1.377168949771689632e-01 1.395433789954337866e-01 1.422831050228310634e-01 1.457534246575342418e-01 1.459360730593607380e-01 1.450228310502283124e-01 1.464840182648401712e-01 1.441095890410958869e-01 1.395433789954337866e-01 1.388127853881278573e-01 1.320547945205479412e-01
1.159817351598173563e-01 1.183561643835616406e-01 1.221917808219178114e-01 1.252968036529680251e-01 1.271232876712328763e-01 1.291324200913241960e-01 1.298630136986301253e-01 1.304109589041095862e-01 1.349771689497716864e-01 1.346118721461187218e-01 1.369863013698630061e-01 1.413698630136986378e-01 1.457534246575342418e-01 1.468493150684931636e-01 1.439269406392694184e-01 1.442922374429223831e-01 1.421004566210045672e-01 1.402739726027397160e-01 1.406392694063926807e-01 1.366210045662100414e-01 1.322374429223744374e-01
1.165296803652968033e-01 1.220091324200913291e-01 1.254794520547945214e-01 1.280365296803653019e-01 1.300456621004566216e-01 1.294977168949771607e-01 1.304109589041095862e-01 1.320547945205479412e-01 1.366210045662100414e-01 1.360730593607305805e-01 1.380821917808219279e-01 1.380821917808219279e-01 1.428310502283104966e-01 1.464840182648401712e-01 1.419178082191780710e-01 1.419178082191780710e-01 1.388127853881278573e-01 1.431963470319634613e-01 1.371689497716895023e-01 1.320547945205479412e-01 1.293150684931506922e-01
1.178082191780821936e-01 1.245662100456620958e-01 1.300456621004566216e-01 1.291324200913241960e-01 1.302283105022831178e-01 1.309589041095890471e-01 1.320547945205479412e-01 1.342465753424657571e-01 1.377168949771689632e-01 1.410045662100456731e-01 1.411872146118721416e-01 1.402739726027397160e-01 1.422831050228310634e-01 1.453881278538812771e-01 1.431963470319634613e-01 1.415525114155251063e-01 1.417351598173516025e-01 1.400913242009132476e-01 1.335159817351598277e-01 1.324200913242009059e-01 1.276712328767123372e-01
1.183561643835616406e-01 1.221917808219178114e-01 1.304109589041095862e-01 1.271232876712328763e-01 1.304109589041095862e-01 1.309589041095890471e-01 1.335159817351598277e-01 1.324200913242009059e-01 1.377168949771689632e-01 1.384474885844748926e-01 1.419178082191780710e-01 1.397260273972602829e-01 1.388127853881278573e-01 1.402739726027397160e-01 1.402739726027397160e-01 1.422831050228310634e-01 1.437442922374429222e-01 1.426484018264840281e-01 1.382648401826483964e-01 1.335159817351598277e-01 1.293150684931506922e-01
1.165296803652968033e-01 1.245662100456620958e-01 1.262100456621004507e-01 1.276712328767123372e-01 1.316894977168949765e-01 1.278538812785388057e-01 1.324200913242009059e-01 1.313242009132420118e-01 1.377168949771689632e-01 1.371689497716895023e-01 1.397260273972602829e-01 1.391780821917808220e-01 1.388127853881278573e-01 1.389954337899543257e-01 1.386301369863013611e-01 1.411872146118721416e-01 1.389954337899543257e-01 1.415525114155251063e-01 1.393607305936073182e-01 1.311415525114155156e-01 1.220091324200913291e-01
1.174429223744292289e-01 1.227397260273972585e-01 1.265753424657534154e-01 1.282191780821917704e-01 1.294977168949771607e-01 1.267579908675799116e-01 1.304109589041095862e-01 1.304109589041095862e-01 1.362557077625570767e-01 1.382648401826483964e-01 1.378995433789954317e-01 1.375342465753424670e-01 1.382648401826483964e-01 1.384474885844748926e-01 1.371689497716895023e-01 1.395433789954337866e-01 1.371689497716895023e-01 1.371689497716895023e-01 1.327853881278538706e-01 1.260273972602739823e-01 1.154337899543378954e-01
1.170776255707762503e-01 1.207305936073059388e-01 1.243835616438356134e-01 1.247488584474885781e-01 1.258447488584474860e-01 1.256621004566210176e-01 1.293150684931506922e-01 1.302283105022831178e-01 1.351598173515981827e-01 1.388127853881278573e-01 1.378995433789954317e-01 1.355251141552511474e-01 1.346118721461187218e-01 1.342465753424657571e-01 1.338812785388127924e-01 1.335159817351598277e-01 1.304109589041095862e-01 1.291324200913241960e-01 1.273059360730593725e-01 1.212785388127853858e-01 1.105022831050228305e-01
1.141552511415525051e-01 1.168949771689497680e-01 1.210958904109589035e-01 1.243835616438356134e-01 1.229223744292237408e-01 1.240182648401826487e-01 1.260273972602739823e-01 1.267579908675799116e-01 1.294977168949771607e-01 1.313242009132420118e-01 1.338812785388127924e-01 1.316894977168949765e-01 1.300456621004566216e-01 1.300456621004566216e-01 1.249315068493150743e-01 1.260273972602739823e-01 1.229223744292237408e-01 1.190867579908675838e-01 1.203652968036529741e-01 1.143378995433790013e-01 1.053881278538812832e-01
