1.149668874172185412e-01 1.157615894039735055e-01 1.148344370860927138e-01 1.116556291390728428e-01 1.084768211920529857e-01 1.051655629139072873e-01 1.021192052980132436e-01 9.801324503311258096e-02 9.615894039735099763e-02 9.655629139072847977e-02 9.576158940397351549e-02 1.002649006622516603e-01 1.034437086092715175e-01 1.103311258278145690e-01 1.136423841059602674e-01 1.190728476821192039e-01 1.219867549668874201e-01 1.246357615894039678e-01 1.234437086092715213e-01 1.223841059602649023e-01 1.178807947019867575e-01
1.143046357615894043e-01 1.160264900662251603e-01 1.166887417218543110e-01 1.152317880794701960e-01 1.123178807947019936e-01 1.091390728476821226e-01 1.063576158940397337e-01 1.013245033112582794e-01 9.894039735099337263e-02 9.960264900662252341e-02 1.013245033112582794e-01 1.054304635761589420e-01 1.113907284768211881e-01 1.139072847682119222e-01 1.184105960264900670e-01 1.223841059602649023e-01 1.239735099337748309e-01 1.263576158940397376e-01 1.247682119205297951e-01 1.239735099337748309e-01 1.213245033112582832e-01
1.133774834437086126e-01 1.152317880794701960e-01 1.169536423841059658e-01 1.169536423841059658e-01 1.136423841059602674e-01 1.103311258278145690e-01 1.104635761589403964e-01 1.063576158940397337e-01 1.029139072847682079e-01 1.039735099337748409e-01 1.052980132450331147e-01 1.105960264900662238e-01 1.149668874172185412e-01 1.176158940397351027e-01 1.221192052980132475e-01 1.241059602649006582e-01 1.264900662251655650e-01 1.287417218543046304e-01 1.266225165562913924e-01 1.256953642384106007e-01 1.239735099337748309e-01
1.108609271523178785e-01 1.120529801324503250e-01 1.127152317880794757e-01 1.131125827814569579e-01 1.128476821192053031e-01 1.117880794701986702e-01 1.109933774834437059e-01 1.084768211920529857e-01 1.074172185430463528e-01 1.080794701986755035e-01 1.092715231788079500e-01 1.096688741721854321e-01 1.144370860927152317e-01 1.172185430463576206e-01 1.205298013245033051e-01 1.226490066225165571e-01 1.260927152317880828e-01 1.284768211920529757e-01 1.284768211920529757e-01 1.282119205298013209e-01 1.233112582781456940e-01
1.034437086092715175e-01 1.078145695364238349e-01 1.107284768211920511e-01 1.100662251655629142e-01 1.116556291390728428e-01 1.125827814569536484e-01 1.098013245033112595e-01 1.075496688741721801e-01 1.050331125827814599e-01 1.063576158940397337e-01 1.087417218543046404e-01 1.116556291390728428e-01 1.129801324503311305e-01 1.164238410596026424e-01 1.194701986754966860e-01 1.209271523178808011e-01 1.252980132450331185e-01 1.276821192052980114e-01 1.274172185430463566e-01 1.263576158940397376e-01 1.237086092715231761e-01
1.002649006622516603e-01 1.049006622516556325e-01 1.092715231788079500e-01 1.084768211920529857e-01 1.103311258278145690e-01 1.084768211920529857e-01 1.070198675496688706e-01 1.060927152317880789e-01 1.037086092715231722e-01 1.056953642384105968e-01 1.068874172185430432e-01 1.105960264900662238e-01 1.123178807947019936e-01 1.136423841059602674e-01 1.181456953642384122e-01 1.201324503311258229e-01 1.230463576158940392e-01 1.256953642384106007e-01 1.262251655629139102e-01 1.229139072847682118e-01 1.203973509933774777e-01
9.615894039735099763e-02 9.986754966887417817e-02 1.076821192052980075e-01 1.075496688741721801e-01 1.092715231788079500e-01 1.080794701986755035e-01 1.055629139072847694e-01 1.045033112582781504e-01 1.041059602649006682e-01 1.071523178807946980e-01 1.066225165562913885e-01 1.087417218543046404e-01 1.121854304635761523e-01 1.148344370860927138e-01 1.174834437086092753e-01 1.199999999999999956e-01 1.213245033112582832e-01 1.222516556291390749e-01 1.205298013245033051e-01 1.214569536423841106e-01 1.177483443708609301e-01
9.470198675496688256e-02 9.960264900662252341e-02 1.049006622516556325e-01 1.060927152317880789e-01 1.050331125827814599e-01 1.043708609271523230e-01 1.059602649006622516e-01 1.041059602649006682e-01 1.054304635761589420e-01 1.074172185430463528e-01 1.071523178807946980e-01 1.092715231788079500e-01 1.121854304635761523e-01 1.141721854304635769e-01 1.170860927152317932e-01 1.197350993377483408e-01 1.192052980132450313e-01 1.196026490066225134e-01 1.206622516556291325e-01 1.174834437086092753e-01 1.139072847682119222e-01
9.377483443708609090e-02 9.801324503311258096e-02 1.034437086092715175e-01 1.030463576158940353e-01 1.039735099337748409e-01 1.039735099337748409e-01 1.042384105960264956e-01 1.039735099337748409e-01 1.022516556291390710e-01 1.046357615894039778e-01 1.047682119205298051e-01 1.047682119205298051e-01 1.087417218543046404e-01 1.104635761589403964e-01 1.113907284768211881e-01 1.150993377483443686e-01 1.148344370860927138e-01 1.147019867549668865e-01 1.140397350993377495e-01 1.090066225165562952e-01 1.050331125827814599e-01
9.417218543046357304e-02 1.000000000000000056e-01 1.043708609271523230e-01 1.070198675496688706e-01 1.074172185430463528e-01 1.045033112582781504e-01 1.034437086092715175e-01 1.022516556291390710e-01 1.015894039735099341e-01 1.033112582781456901e-01 1.038410596026490135e-01 1.023841059602648984e-01 1.045033112582781504e-01 1.067549668874172158e-01 1.071523178807946980e-01 1.100662251655629142e-01 1.088741721854304678e-01 1.095364238410596047e-01 1.091390728476821226e-01 1.051655629139072873e-01 1.019867549668874163e-01
9.642384105960265239e-02 1.029139072847682079e-01 1.078145695364238349e-01 1.111258278145695333e-01 1.098013245033112595e-01 1.067549668874172158e-01 1.063576158940397337e-01 1.034437086092715175e-01 1.025165562913907258e-01 1.014569536423841067e-01 1.005298013245033151e-01 9.986754966887417817e-02 1.013245033112582794e-01 1.051655629139072873e-01 1.062251655629139063e-01 1.091390728476821226e-01 1.082119205298013309e-01 1.068874172185430432e-01 1.062251655629139063e-01 1.021192052980132436e-01 9.854304635761589048e-02
9.907284768211920001e-02 1.039735099337748409e-01 1.113907284768211881e-01 1.135099337748344400e-01 1.125827814569536484e-01 1.108609271523178785e-01 1.082119205298013309e-01 1.054304635761589420e-01 1.031788079470198627e-01 1.018543046357615889e-01 1.007947019867549698e-01 9.841059602649006310e-02 1.019867549668874163e-01 1.045033112582781504e-01 1.058278145695364242e-01 1.075496688741721801e-01 1.059602649006622516e-01 1.058278145695364242e-01 1.030463576158940353e-01 9.827814569536423572e-02 9.350993377483443614e-02
1.052980132450331147e-01 1.092715231788079500e-01 1.164238410596026424e-01 1.172185430463576206e-01 1.162913907284768150e-01 1.160264900662251603e-01 1.143046357615894043e-01 1.083443708609271583e-01 1.051655629139072873e-01 1.018543046357615889e-01 1.000000000000000056e-01 1.002649006622516603e-01 1.000000000000000056e-01 1.033112582781456901e-01 1.062251655629139063e-01 1.079470198675496623e-01 1.075496688741721801e-01 1.074172185430463528e-01 1.062251655629139063e-01 1.000000000000000056e-01 9.589403973509934287e-02
1.076821192052980075e-01 1.129801324503311305e-01 1.176158940397351027e-01 1.201324503311258229e-01 1.207947019867549737e-01 1.198675496688741682e-01 1.174834437086092753e-01 1.144370860927152317e-01 1.091390728476821226e-01 1.063576158940397337e-01 1.025165562913907258e-01 1.009271523178807972e-01 1.035761589403973448e-01 1.046357615894039778e-01 1.070198675496688706e-01 1.090066225165562952e-01 1.116556291390728428e-01 1.115231788079470154e-01 1.070198675496688706e-01 1.031788079470198627e-01 9.748344370860927144e-02
1.107284768211920511e-01 1.160264900662251603e-01 1.214569536423841106e-01 1.225165562913907297e-01 1.225165562913907297e-01 1.215894039735099380e-01 1.178807947019867575e-01 1.149668874172185412e-01 1.104635761589403964e-01 1.062251655629139063e-01 1.025165562913907258e-01 1.045033112582781504e-01 1.054304635761589420e-01 1.080794701986755035e-01 1.086092715231788131e-01 1.109933774834437059e-01 1.127152317880794757e-01 1.125827814569536484e-01 1.112582781456953607e-01 1.075496688741721801e-01 1.001324503311258329e-01
1.152317880794701960e-01 1.180132450331125848e-01 1.233112582781456940e-01 1.270198675496688745e-01 1.260927152317880828e-01 1.239735099337748309e-01 1.209271523178808011e-01 1.170860927152317932e-01 1.103311258278145690e-01 1.072847682119205254e-01 1.074172185430463528e-01 1.066225165562913885e-01 1.096688741721854321e-01 1.095364238410596047e-01 1.100662251655629142e-01 1.140397350993377495e-01 1.158940397350993329e-01 1.165562913907284837e-01 1.136423841059602674e-01 1.083443708609271583e-01 1.029139072847682079e-01
1.190728476821192039e-01 1.233112582781456940e-01 1.256953642384106007e-01 1.288741721854304578e-01 1.278145695364238388e-01 1.268874172185430471e-01 1.233112582781456940e-01 1.172185430463576206e-01 1.128476821192053031e-01 1.088741721854304678e-01 1.079470198675496623e-01 1.080794701986755035e-01 1.100662251655629142e-01 1.129801324503311305e-01 1.107284768211920511e-01 1.141721854304635769e-01 1.157615894039735055e-01 1.139072847682119222e-01 1.144370860927152317e-01 1.080794701986755035e-01 1.014569536423841067e-01
1.211920529801324559e-01 1.222516556291390749e-01 1.258278145695364281e-01 1.275496688741721840e-01 1.266225165562913924e-01 1.262251655629139102e-01 1.217218543046357654e-01 1.190728476821192039e-01 1.153642384105960234e-01 1.095364238410596047e-01 1.080794701986755035e-01 1.056953642384105968e-01 1.082119205298013309e-01 1.087417218543046404e-01 1.111258278145695333e-01 1.108609271523178785e-01 1.116556291390728428e-01 1.137748344370860948e-01 1.123178807947019936e-01 1.091390728476821226e-01 1.033112582781456901e-01
1.205298013245033051e-01 1.234437086092715213e-01 1.266225165562913924e-01 1.263576158940397376e-01 1.262251655629139102e-01 1.251655629139072912e-01 1.205298013245033051e-01 1.174834437086092753e-01 1.124503311258278210e-01 1.082119205298013309e-01 1.051655629139072873e-01 1.041059602649006682e-01 1.049006622516556325e-01 1.074172185430463528e-01 1.086092715231788131e-01 1.099337748344370869e-01 1.099337748344370869e-01 1.091390728476821226e-01 1.063576158940397337e-01 1.042384105960264956e-01 1.026490066225165532e-01
1.174834437086092753e-01 1.178807947019867575e-01 1.227814569536423844e-01 1.241059602649006582e-01 1.243708609271523130e-01 1.251655629139072912e-01 1.197350993377483408e-01 1.136423841059602674e-01 1.078145695364238349e-01 1.039735099337748409e-01 1.023841059602648984e-01 9.894039735099337263e-02 9.973509933774835079e-02 1.013245033112582794e-01 1.029139072847682079e-01 1.043708609271523230e-01 1.062251655629139063e-01 1.021192052980132436e-01 1.002649006622516603e-01 9.735099337748344406e-02 9.483443708609270995e-02
1.161589403973509876e-01 1.198675496688741682e-01 1.230463576158940392e-01 1.223841059602649023e-01 1.221192052980132475e-01 1.201324503311258229e-01 1.156291390728476781e-01 1.098013245033112595e-01 1.055629139072847694e-01 1.037086092715231722e-01 9.827814569536423572e-02 9.496688741721853733e-02 9.562913907284768811e-02 9.721854304635761668e-02 9.920529801324502739e-02 1.013245033112582794e-01 1.011920529801324520e-01 9.920529801324502739e-02 9.403973509933774566e-02 9.245033112582781709e-02 8.953642384105960084e-02
