1.284207715925777538e-01 1.297557068482178555e-01 1.290882392203978046e-01 1.237484981978374116e-01 1.229475370444533394e-01 1.190762248030970555e-01 1.145374449339207068e-01 1.140034708316646633e-01 1.133360032038446125e-01 1.145374449339207068e-01 1.204111600587371572e-01 1.244159658256574624e-01 1.281537845414497390e-01 1.321585903083700442e-01 1.317581097316780081e-01 1.328260579361900950e-01 1.320250967828060229e-01 1.313576291549859720e-01 1.270858363369376520e-01 1.252169269790415207e-01 1.224135629421973098e-01
1.314911226805499933e-01 1.324255773594980590e-01 1.336270190895741672e-01 1.301561874249098916e-01 1.264183687091176012e-01 1.221465758910692812e-01 1.198771859564811137e-01 1.180082765985849685e-01 1.170738219196369029e-01 1.210786276865572081e-01 1.237484981978374116e-01 1.297557068482178555e-01 1.316246162061140146e-01 1.348284608196502476e-01 1.356294219730343198e-01 1.358964090241623346e-01 1.349619543452142689e-01 1.317581097316780081e-01 1.305566680016019276e-01 1.266853557602456160e-01 1.230810305700173607e-01
1.286877586437057686e-01 1.317581097316780081e-01 1.320250967828060229e-01 1.292217327459618259e-01 1.282872780670137602e-01 1.286877586437057686e-01 1.228140435188893320e-01 1.193432118542250703e-01 1.210786276865572081e-01 1.244159658256574624e-01 1.268188492858096372e-01 1.341609931918301968e-01 1.365638766519823855e-01 1.370978507542384150e-01 1.366973701775463790e-01 1.365638766519823855e-01 1.364303831264183642e-01 1.336270190895741672e-01 1.322920838339340655e-01 1.305566680016019276e-01 1.265518622346816224e-01
1.248164464023494846e-01 1.286877586437057686e-01 1.289547456948338111e-01 1.294887197970898407e-01 1.289547456948338111e-01 1.276198104391937094e-01 1.254839140301695355e-01 1.236150046722733903e-01 1.234815111467093829e-01 1.254839140301695355e-01 1.294887197970898407e-01 1.360299025497263281e-01 1.391002536376985677e-01 1.408356694700307055e-01 1.364303831264183642e-01 1.397677212655186185e-01 1.370978507542384150e-01 1.342944867173942181e-01 1.325590708850620802e-01 1.293552262715258194e-01 1.265518622346816224e-01
1.240154852489654264e-01 1.270858363369376520e-01 1.264183687091176012e-01 1.288212521692697898e-01 1.280202910158857177e-01 1.241489787745294338e-01 1.238819917234014190e-01 1.226805499933253246e-01 1.217460953143772590e-01 1.256174075557335568e-01 1.278867974903217242e-01 1.346949672940862264e-01 1.396342277399546250e-01 1.388332665865705529e-01 1.373648378053664298e-01 1.385662795354425381e-01 1.389667601121345741e-01 1.362968896008543707e-01 1.328260579361900950e-01 1.308236550527299424e-01 1.277533039647577029e-01
1.229475370444533394e-01 1.234815111467093829e-01 1.246829528767854772e-01 1.268188492858096372e-01 1.257509010812975503e-01 1.249499399279134920e-01 1.264183687091176012e-01 1.250834334534774994e-01 1.249499399279134920e-01 1.289547456948338111e-01 1.309571485782939637e-01 1.358964090241623346e-01 1.361633960752903494e-01 1.362968896008543707e-01 1.357629154985983133e-01 1.374983313309304511e-01 1.366973701775463790e-01 1.337605126151381607e-01 1.332265385128821311e-01 1.298892003737818768e-01 1.242824723000934412e-01
1.174743024963289251e-01 1.205446535843011646e-01 1.214791082632492303e-01 1.214791082632492303e-01 1.232145240955813681e-01 1.252169269790415207e-01 1.278867974903217242e-01 1.257509010812975503e-01 1.274863169136296881e-01 1.277533039647577029e-01 1.294887197970898407e-01 1.333600320384461246e-01 1.350954478707782624e-01 1.348284608196502476e-01 1.337605126151381607e-01 1.362968896008543707e-01 1.360299025497263281e-01 1.330930449873181098e-01 1.328260579361900950e-01 1.288212521692697898e-01 1.238819917234014190e-01
1.156053931384327799e-01 1.176077960218929325e-01 1.208116406354291794e-01 1.213456147376852229e-01 1.240154852489654264e-01 1.257509010812975503e-01 1.241489787745294338e-01 1.253504205046055142e-01 1.280202910158857177e-01 1.288212521692697898e-01 1.296222133226538620e-01 1.329595514617541163e-01 1.338940061407021820e-01 1.318916032572420294e-01 1.337605126151381607e-01 1.332265385128821311e-01 1.337605126151381607e-01 1.310906421038579572e-01 1.288212521692697898e-01 1.221465758910692812e-01 1.186757442264050194e-01
1.149379255106127290e-01 1.177412895474569537e-01 1.213456147376852229e-01 1.230810305700173607e-01 1.268188492858096372e-01 1.250834334534774994e-01 1.282872780670137602e-01 1.296222133226538620e-01 1.306901615271659212e-01 1.306901615271659212e-01 1.330930449873181098e-01 1.352289413963422837e-01 1.342944867173942181e-01 1.321585903083700442e-01 1.334935255640101459e-01 1.342944867173942181e-01 1.316246162061140146e-01 1.264183687091176012e-01 1.226805499933253246e-01 1.197436924309171064e-01 1.141369643572286707e-01
1.158723801895608085e-01 1.204111600587371572e-01 1.228140435188893320e-01 1.234815111467093829e-01 1.274863169136296881e-01 1.280202910158857177e-01 1.298892003737818768e-01 1.305566680016019276e-01 1.321585903083700442e-01 1.326925644106260738e-01 1.361633960752903494e-01 1.352289413963422837e-01 1.345614737685222329e-01 1.329595514617541163e-01 1.316246162061140146e-01 1.329595514617541163e-01 1.304231744760379064e-01 1.248164464023494846e-01 1.217460953143772590e-01 1.157388866639968011e-01 1.089307168602322851e-01
1.184087571752770046e-01 1.224135629421973098e-01 1.262848751835536076e-01 1.288212521692697898e-01 1.305566680016019276e-01 1.317581097316780081e-01 1.340274996662661755e-01 1.344279802429582116e-01 1.376318248564944724e-01 1.364303831264183642e-01 1.350954478707782624e-01 1.356294219730343198e-01 1.356294219730343198e-01 1.329595514617541163e-01 1.356294219730343198e-01 1.326925644106260738e-01 1.277533039647577029e-01 1.210786276865572081e-01 1.184087571752770046e-01 1.138699773061006559e-01 1.081297557068482129e-01
1.228140435188893320e-01 1.245494593512214698e-01 1.277533039647577029e-01 1.329595514617541163e-01 1.341609931918301968e-01 1.333600320384461246e-01 1.369643572286744215e-01 1.366973701775463790e-01 1.366973701775463790e-01 1.373648378053664298e-01 1.360299025497263281e-01 1.372313442798024363e-01 1.361633960752903494e-01 1.356294219730343198e-01 1.346949672940862264e-01 1.296222133226538620e-01 1.266853557602456160e-01 1.194767053797890777e-01 1.205446535843011646e-01 1.133360032038446125e-01 1.057268722466960381e-01
1.277533039647577029e-01 1.297557068482178555e-01 1.313576291549859720e-01 1.329595514617541163e-01 1.372313442798024363e-01 1.368308637031104003e-01 1.386997730610065316e-01 1.368308637031104003e-01 1.377653183820584659e-01 1.349619543452142689e-01 1.346949672940862264e-01 1.366973701775463790e-01 1.365638766519823855e-01 1.357629154985983133e-01 1.316246162061140146e-01 1.288212521692697898e-01 1.250834334534774994e-01 1.184087571752770046e-01 1.160058737151248159e-01 1.109331197436924377e-01 1.023895341075957838e-01
1.317581097316780081e-01 1.337605126151381607e-01 1.362968896008543707e-01 1.372313442798024363e-01 1.388332665865705529e-01 1.397677212655186185e-01 1.404351888933386694e-01 1.385662795354425381e-01 1.396342277399546250e-01 1.372313442798024363e-01 1.354959284474702985e-01 1.365638766519823855e-01 1.353624349219062772e-01 1.340274996662661755e-01 1.317581097316780081e-01 1.286877586437057686e-01 1.254839140301695355e-01 1.188092377519690268e-01 1.166733413429448668e-01 1.085302362835402490e-01 1.011880923775196894e-01
1.340274996662661755e-01 1.377653183820584659e-01 1.382992924843145233e-01 1.381657989587505020e-01 1.415031370978507563e-01 1.405686824189026907e-01 1.369643572286744215e-01 1.381657989587505020e-01 1.378988119076224872e-01 1.395007342143906037e-01 1.357629154985983133e-01 1.332265385128821311e-01 1.309571485782939637e-01 1.306901615271659212e-01 1.276198104391937094e-01 1.282872780670137602e-01 1.234815111467093829e-01 1.170738219196369029e-01 1.126685355760245616e-01 1.049259110933119798e-01 9.571485782939527509e-02
1.346949672940862264e-01 1.368308637031104003e-01 1.381657989587505020e-01 1.407021759444666842e-01 1.400347083166466333e-01 1.408356694700307055e-01 1.373648378053664298e-01 1.370978507542384150e-01 1.384327860098785168e-01 1.369643572286744215e-01 1.317581097316780081e-01 1.305566680016019276e-01 1.282872780670137602e-01 1.252169269790415207e-01 1.264183687091176012e-01 1.221465758910692812e-01 1.212121212121212155e-01 1.130690161527165977e-01 1.086637298091042564e-01 1.022560405820317764e-01 9.211053263916700595e-02
1.344279802429582116e-01 1.349619543452142689e-01 1.388332665865705529e-01 1.399012147910826398e-01 1.400347083166466333e-01 1.392337471632625889e-01 1.385662795354425381e-01 1.369643572286744215e-01 1.357629154985983133e-01 1.318916032572420294e-01 1.266853557602456160e-01 1.294887197970898407e-01 1.230810305700173607e-01 1.225470564677613172e-01 1.204111600587371572e-01 1.177412895474569537e-01 1.129355226271525764e-01 1.087972233346682638e-01 1.026565211587237986e-01 9.464690962488318815e-02 8.677079161660659901e-02
1.316246162061140146e-01 1.344279802429582116e-01 1.354959284474702985e-01 1.356294219730343198e-01 1.366973701775463790e-01 1.376318248564944724e-01 1.334935255640101459e-01 1.313576291549859720e-01 1.293552262715258194e-01 1.286877586437057686e-01 1.253504205046055142e-01 1.234815111467093829e-01 1.221465758910692812e-01 1.206781471098651720e-01 1.201441730076091285e-01 1.129355226271525764e-01 1.065278334000800964e-01 1.039914564143639003e-01 9.638232545721532596e-02 8.957415565345080988e-02 8.329995995194233727e-02
1.280202910158857177e-01 1.302896809504739128e-01 1.314911226805499933e-01 1.345614737685222329e-01 1.336270190895741672e-01 1.354959284474702985e-01 1.312241356294219785e-01 1.280202910158857177e-01 1.252169269790415207e-01 1.221465758910692812e-01 1.208116406354291794e-01 1.192097183286610629e-01 1.149379255106127290e-01 1.140034708316646633e-01 1.116005873715124885e-01 1.069283139767721325e-01 1.007876118008276534e-01 9.451341609931918075e-02 8.797223334668267947e-02 8.236550527299425772e-02 7.996262181284208292e-02
1.240154852489654264e-01 1.277533039647577029e-01 1.296222133226538620e-01 1.288212521692697898e-01 1.278867974903217242e-01 1.284207715925777538e-01 1.256174075557335568e-01 1.228140435188893320e-01 1.214791082632492303e-01 1.190762248030970555e-01 1.164063542918168520e-01 1.125350420504605542e-01 1.122680549993325255e-01 1.085302362835402490e-01 1.034574823121078568e-01 9.664931250834334076e-02 9.211053263916700595e-02 8.610332398878654814e-02 8.236550527299425772e-02 7.809371245494593772e-02 7.529034841810172685e-02
1.216126017888132377e-01 1.242824723000934412e-01 1.256174075557335568e-01 1.256174075557335568e-01 1.260178881324255651e-01 1.228140435188893320e-01 1.205446535843011646e-01 1.168068348685088742e-01 1.149379255106127290e-01 1.099986650647443581e-01 1.062608463489520816e-01 1.050594046188759872e-01 1.031904952609798420e-01 1.007876118008276534e-01 9.731678013616339162e-02 9.050861033239887554e-02 8.583633693765851946e-02 8.316646642637831599e-02 7.876118008276598859e-02 7.715925777599785818e-02 7.395541316246162511e-02
