1.241528869612361086e-01 1.255082678232583293e-01 1.226619680130116574e-01 1.227975060992138739e-01 1.200867443751694186e-01 1.169693683925182998e-01 1.162916779615071894e-01 1.105990783410138317e-01 1.107346164272160483e-01 1.085660070479804867e-01 1.095147736513960440e-01 1.149362970994849548e-01 1.181892111683383040e-01 1.255082678232583293e-01 1.306587150989428070e-01 1.367579289780428420e-01 1.367579289780428420e-01 1.354025481160205935e-01 1.352670100298183908e-01 1.314719436161561339e-01 1.279479533748983378e-01
1.280834914611005682e-01 1.306587150989428070e-01 1.276768772024939047e-01 1.264570344266738866e-01 1.245595012198427720e-01 1.234751965302249982e-01 1.195445920303605247e-01 1.168338303063160694e-01 1.149362970994849548e-01 1.161561398753049590e-01 1.158850637029005121e-01 1.210355109785849759e-01 1.241528869612361086e-01 1.299810246679316827e-01 1.363513147194361508e-01 1.410951477365139650e-01 1.412306858227161954e-01 1.400108430468961773e-01 1.386554621848739566e-01 1.340471672539983727e-01 1.314719436161561339e-01
1.276768772024939047e-01 1.268636486852805501e-01 1.268636486852805501e-01 1.276768772024939047e-01 1.275413391162916743e-01 1.238818107888316616e-01 1.218487394957983166e-01 1.192735158579560917e-01 1.195445920303605247e-01 1.179181349959338571e-01 1.191379777717538613e-01 1.244239631336405555e-01 1.278124152886961351e-01 1.322851721333694885e-01 1.370290051504472750e-01 1.406885334779073016e-01 1.404174573055028408e-01 1.387910002710761592e-01 1.377066955814583993e-01 1.368934670642450446e-01 1.347248576850094970e-01
1.230685822716183209e-01 1.257793439956627901e-01 1.288967199783138950e-01 1.249661154784494493e-01 1.282190295473027986e-01 1.267281105990783474e-01 1.240173488750338782e-01 1.226619680130116574e-01 1.207644348061805428e-01 1.175115207373271936e-01 1.204933586337760959e-01 1.264570344266738866e-01 1.309297912713472400e-01 1.317430197885605947e-01 1.381133098400650627e-01 1.391976145296828504e-01 1.412306858227161954e-01 1.401463811330984077e-01 1.379777717538628323e-01 1.378422336676606019e-01 1.359447004608294873e-01
1.177825969097316405e-01 1.229330441854161043e-01 1.222553537544049940e-01 1.251016535646516659e-01 1.246950393060450024e-01 1.265925725128761170e-01 1.227975060992138739e-01 1.214421252371916532e-01 1.207644348061805428e-01 1.202222824613716490e-01 1.210355109785849759e-01 1.283545676335050012e-01 1.312008674437517008e-01 1.349959338574139300e-01 1.375711574952561689e-01 1.408240715641095042e-01 1.410951477365139650e-01 1.408240715641095042e-01 1.409596096503117346e-01 1.409596096503117346e-01 1.373000813228517081e-01
1.153429113580916182e-01 1.177825969097316405e-01 1.229330441854161043e-01 1.255082678232583293e-01 1.234751965302249982e-01 1.256438059094605597e-01 1.246950393060450024e-01 1.227975060992138739e-01 1.215776633233938697e-01 1.206288967199783124e-01 1.234751965302249982e-01 1.290322580645161255e-01 1.320140959609650277e-01 1.339116291677961423e-01 1.363513147194361508e-01 1.429926809433450796e-01 1.420439143399295223e-01 1.435348332881539735e-01 1.413662239089183981e-01 1.383843860124694958e-01 1.341827053402006031e-01
1.142586066684738444e-01 1.188669015993494144e-01 1.203578205475738655e-01 1.202222824613716490e-01 1.215776633233938697e-01 1.219842775820005470e-01 1.215776633233938697e-01 1.234751965302249982e-01 1.207644348061805428e-01 1.218487394957983166e-01 1.226619680130116574e-01 1.263214963404716840e-01 1.282190295473027986e-01 1.322851721333694885e-01 1.352670100298183908e-01 1.393331526158850531e-01 1.406885334779073016e-01 1.409596096503117346e-01 1.408240715641095042e-01 1.355380862022228239e-01 1.305231770127405766e-01
1.120899972892382829e-01 1.164272160477094059e-01 1.184602873407427509e-01 1.198156682027649717e-01 1.196801301165627551e-01 1.213065871509894228e-01 1.227975060992138739e-01 1.217132014095961001e-01 1.219842775820005470e-01 1.225264299268094270e-01 1.210355109785849759e-01 1.233396584440227678e-01 1.260504201680672232e-01 1.288967199783138950e-01 1.340471672539983727e-01 1.358091623746272569e-01 1.381133098400650627e-01 1.387910002710761592e-01 1.373000813228517081e-01 1.340471672539983727e-01 1.279479533748983378e-01
1.084304689617782563e-01 1.116833830306316055e-01 1.146652209270805078e-01 1.184602873407427509e-01 1.181892111683383040e-01 1.233396584440227678e-01 1.218487394957983166e-01 1.202222824613716490e-01 1.208999728923827593e-01 1.223908918406072105e-01 1.213065871509894228e-01 1.246950393060450024e-01 1.264570344266738866e-01 1.303876389265383462e-01 1.317430197885605947e-01 1.358091623746272569e-01 1.378422336676606019e-01 1.359447004608294873e-01 1.340471672539983727e-01 1.280834914611005682e-01 1.202222824613716490e-01
1.057197072377338010e-01 1.104635402548116013e-01 1.148007590132827382e-01 1.179181349959338571e-01 1.206288967199783124e-01 1.219842775820005470e-01 1.221198156682027636e-01 1.230685822716183209e-01 1.214421252371916532e-01 1.222553537544049940e-01 1.222553537544049940e-01 1.248305773922472189e-01 1.276768772024939047e-01 1.280834914611005682e-01 1.302521008403361436e-01 1.343182434264028058e-01 1.360802385470317177e-01 1.330984006505828154e-01 1.291677961507183559e-01 1.251016535646516659e-01 1.183247492545405205e-01
1.093792355651938136e-01 1.129032258064516098e-01 1.171049064787205163e-01 1.184602873407427509e-01 1.232041203578205513e-01 1.234751965302249982e-01 1.232041203578205513e-01 1.226619680130116574e-01 1.222553537544049940e-01 1.214421252371916532e-01 1.233396584440227678e-01 1.241528869612361086e-01 1.286256438059094620e-01 1.282190295473027986e-01 1.303876389265383462e-01 1.312008674437517008e-01 1.330984006505828154e-01 1.314719436161561339e-01 1.290322580645161255e-01 1.242884250474383251e-01 1.154784494442938486e-01
1.150718351856871713e-01 1.190024396855516448e-01 1.206288967199783124e-01 1.264570344266738866e-01 1.246950393060450024e-01 1.282190295473027986e-01 1.274058010300894439e-01 1.256438059094605597e-01 1.225264299268094270e-01 1.222553537544049940e-01 1.229330441854161043e-01 1.255082678232583293e-01 1.267281105990783474e-01 1.286256438059094620e-01 1.284901057197072316e-01 1.307942531851450374e-01 1.318785578747627973e-01 1.301165627541339131e-01 1.279479533748983378e-01 1.211710490647872063e-01 1.153429113580916182e-01
1.211710490647872063e-01 1.238818107888316616e-01 1.280834914611005682e-01 1.316074817023583643e-01 1.303876389265383462e-01 1.305231770127405766e-01 1.272702629438872413e-01 1.272702629438872413e-01 1.253727297370560989e-01 1.217132014095961001e-01 1.214421252371916532e-01 1.244239631336405555e-01 1.252371916508538963e-01 1.269991867714827805e-01 1.280834914611005682e-01 1.286256438059094620e-01 1.309297912713472400e-01 1.282190295473027986e-01 1.240173488750338782e-01 1.187313635131471978e-01 1.127676877202493932e-01
1.226619680130116574e-01 1.284901057197072316e-01 1.297099484955272497e-01 1.326917863919761520e-01 1.307942531851450374e-01 1.325562483057739216e-01 1.309297912713472400e-01 1.299810246679316827e-01 1.290322580645161255e-01 1.251016535646516659e-01 1.242884250474383251e-01 1.238818107888316616e-01 1.252371916508538963e-01 1.248305773922472189e-01 1.288967199783138950e-01 1.284901057197072316e-01 1.299810246679316827e-01 1.275413391162916743e-01 1.244239631336405555e-01 1.175115207373271936e-01 1.115478449444293890e-01
1.275413391162916743e-01 1.320140959609650277e-01 1.360802385470317177e-01 1.377066955814583993e-01 1.348603957712116996e-01 1.355380862022228239e-01 1.383843860124694958e-01 1.341827053402006031e-01 1.309297912713472400e-01 1.286256438059094620e-01 1.261859582542694536e-01 1.261859582542694536e-01 1.260504201680672232e-01 1.260504201680672232e-01 1.290322580645161255e-01 1.310653293575494704e-01 1.310653293575494704e-01 1.287611818921116924e-01 1.237462727026294451e-01 1.145296828408782913e-01 1.073461642721604825e-01
1.295744104093250193e-01 1.351314719436161604e-01 1.382488479262672931e-01 1.396042287882895139e-01 1.374356194090539385e-01 1.367579289780428420e-01 1.374356194090539385e-01 1.349959338574139300e-01 1.317430197885605947e-01 1.293033342369205863e-01 1.265925725128761170e-01 1.271347248576850109e-01 1.271347248576850109e-01 1.268636486852805501e-01 1.280834914611005682e-01 1.302521008403361436e-01 1.294388723231227889e-01 1.256438059094605597e-01 1.208999728923827593e-01 1.131743019788560567e-01 1.043643263757115802e-01
1.337760910815939397e-01 1.363513147194361508e-01 1.393331526158850531e-01 1.390620764434806200e-01 1.410951477365139650e-01 1.391976145296828504e-01 1.378422336676606019e-01 1.356736242884250543e-01 1.328273244781783546e-01 1.290322580645161255e-01 1.271347248576850109e-01 1.288967199783138950e-01 1.298454865817294523e-01 1.261859582542694536e-01 1.297099484955272497e-01 1.302521008403361436e-01 1.287611818921116924e-01 1.246950393060450024e-01 1.168338303063160694e-01 1.061263214963404783e-01 1.031444835998915760e-01
1.316074817023583643e-01 1.363513147194361508e-01 1.381133098400650627e-01 1.379777717538628323e-01 1.405529953917050712e-01 1.402819192193006104e-01 1.390620764434806200e-01 1.349959338574139300e-01 1.336405529953917093e-01 1.298454865817294523e-01 1.297099484955272497e-01 1.288967199783138950e-01 1.286256438059094620e-01 1.287611818921116924e-01 1.261859582542694536e-01 1.276768772024939047e-01 1.259148820818649928e-01 1.233396584440227678e-01 1.153429113580916182e-01 1.080238547031715929e-01 9.690973163458932449e-02
1.314719436161561339e-01 1.349959338574139300e-01 1.355380862022228239e-01 1.417728381675250615e-01 1.429926809433450796e-01 1.415017619951206285e-01 1.387910002710761592e-01 1.358091623746272569e-01 1.329628625643805850e-01 1.298454865817294523e-01 1.259148820818649928e-01 1.248305773922472189e-01 1.259148820818649928e-01 1.255082678232583293e-01 1.248305773922472189e-01 1.240173488750338782e-01 1.246950393060450024e-01 1.203578205475738655e-01 1.138519924098671671e-01 1.042287882895093498e-01 9.623204120357820024e-02
1.299810246679316827e-01 1.310653293575494704e-01 1.345893195988072666e-01 1.377066955814583993e-01 1.412306858227161954e-01 1.391976145296828504e-01 1.375711574952561689e-01 1.321496340471672581e-01 1.298454865817294523e-01 1.253727297370560989e-01 1.217132014095961001e-01 1.206288967199783124e-01 1.203578205475738655e-01 1.198156682027649717e-01 1.213065871509894228e-01 1.179181349959338571e-01 1.177825969097316405e-01 1.138519924098671671e-01 1.088370832203849337e-01 1.009758742206560006e-01 9.365681756573597527e-02
1.284901057197072316e-01 1.295744104093250193e-01 1.314719436161561339e-01 1.349959338574139300e-01 1.359447004608294873e-01 1.364868528056383812e-01 1.347248576850094970e-01 1.298454865817294523e-01 1.240173488750338782e-01 1.190024396855516448e-01 1.156139875304960651e-01 1.143941447546760609e-01 1.124966115478449463e-01 1.135809162374627201e-01 1.135809162374627201e-01 1.095147736513960440e-01 1.101924640824071544e-01 1.068040119273515887e-01 1.013824884792626779e-01 9.392789373814042220e-02 8.904852263486039143e-02
