1.098831300813008088e-01 1.117886178861788593e-01 1.115345528455284618e-01 1.068343495934959281e-01 1.065802845528455306e-01 1.065802845528455306e-01 1.077235772357723609e-01 1.075965447154471483e-01 1.095020325203251987e-01 1.140752032520325199e-01 1.180132113821138196e-01 1.214430894308943104e-01 1.267784552845528379e-01 1.300813008130081438e-01 1.285569105691057035e-01 1.300813008130081438e-01 1.283028455284552782e-01 1.281758130081300795e-01 1.262703252032520429e-01 1.230945121951219495e-01 1.202997967479674801e-01
1.098831300813008088e-01 1.136941056910569098e-01 1.129319105691056896e-01 1.103912601626016315e-01 1.082317073170731697e-01 1.095020325203251987e-01 1.128048780487804909e-01 1.122967479674796681e-01 1.153455284552845489e-01 1.183943089430894297e-01 1.230945121951219495e-01 1.255081300813008227e-01 1.291920731707316972e-01 1.345274390243902385e-01 1.327489837398374006e-01 1.321138211382113792e-01 1.330030487804877981e-01 1.317327235772357830e-01 1.288109756097561009e-01 1.262703252032520429e-01 1.215701219512195091e-01
1.065802845528455306e-01 1.128048780487804909e-01 1.131859756097561009e-01 1.114075203252032492e-01 1.075965447154471483e-01 1.087398373983739785e-01 1.110264227642276391e-01 1.144563008130081300e-01 1.180132113821138196e-01 1.205538617886178915e-01 1.252540650406503975e-01 1.274136178861788593e-01 1.309705284552845628e-01 1.369410569105690978e-01 1.364329268292683028e-01 1.347815040650406637e-01 1.364329268292683028e-01 1.345274390243902385e-01 1.307164634146341375e-01 1.284298780487804770e-01 1.215701219512195091e-01
1.051829268292682890e-01 1.070884146341463394e-01 1.101371951219512202e-01 1.084857723577235811e-01 1.086128048780487798e-01 1.075965447154471483e-01 1.095020325203251987e-01 1.161077235772357691e-01 1.183943089430894297e-01 1.241107723577235811e-01 1.283028455284552782e-01 1.303353658536585413e-01 1.330030487804877981e-01 1.356707317073170826e-01 1.364329268292683028e-01 1.363058943089430763e-01 1.375762195121951192e-01 1.355436991869918562e-01 1.316056910569105565e-01 1.274136178861788593e-01 1.219512195121951192e-01
1.058180894308943104e-01 1.077235772357723609e-01 1.103912601626016315e-01 1.095020325203251987e-01 1.091209349593495886e-01 1.098831300813008088e-01 1.115345528455284618e-01 1.163617886178861804e-01 1.200457317073170688e-01 1.225863821138211407e-01 1.269054878048780366e-01 1.295731707317073211e-01 1.321138211382113792e-01 1.338922764227642170e-01 1.374491869918699205e-01 1.383384146341463394e-01 1.389735772357723609e-01 1.355436991869918562e-01 1.337652439024390183e-01 1.271595528455284618e-01 1.215701219512195091e-01
1.050558943089430902e-01 1.089939024390243899e-01 1.111534552845528517e-01 1.114075203252032492e-01 1.107723577235772416e-01 1.107723577235772416e-01 1.172510162601625994e-01 1.171239837398374006e-01 1.232215447154471483e-01 1.238567073170731697e-01 1.289380081300812997e-01 1.328760162601625994e-01 1.321138211382113792e-01 1.338922764227642170e-01 1.368140243902438991e-01 1.365599593495935016e-01 1.371951219512195230e-01 1.359247967479674801e-01 1.312245934959349603e-01 1.272865853658536606e-01 1.205538617886178915e-01
1.065802845528455306e-01 1.093750000000000000e-01 1.158536585365853716e-01 1.139481707317073211e-01 1.150914634146341514e-01 1.148373983739837401e-01 1.187754065040650397e-01 1.220782520325203319e-01 1.228404471544715382e-01 1.270325203252032631e-01 1.299542682926829174e-01 1.330030487804877981e-01 1.345274390243902385e-01 1.349085365853658625e-01 1.364329268292683028e-01 1.378302845528455167e-01 1.374491869918699205e-01 1.350355691056910612e-01 1.326219512195122019e-01 1.261432926829268164e-01 1.176321138211382095e-01
1.102642276422764189e-01 1.145833333333333287e-01 1.190294715447154511e-01 1.178861788617886208e-01 1.162347560975609817e-01 1.172510162601625994e-01 1.205538617886178915e-01 1.233485772357723609e-01 1.232215447154471483e-01 1.255081300813008227e-01 1.298272357723577186e-01 1.316056910569105565e-01 1.314786585365853577e-01 1.327489837398374006e-01 1.346544715447154372e-01 1.355436991869918562e-01 1.357977642276422814e-01 1.331300813008129968e-01 1.305894308943089388e-01 1.247459349593495886e-01 1.163617886178861804e-01
1.135670731707317110e-01 1.190294715447154511e-01 1.224593495934959281e-01 1.232215447154471483e-01 1.232215447154471483e-01 1.236026422764227584e-01 1.252540650406503975e-01 1.255081300813008227e-01 1.266514227642276391e-01 1.302083333333333426e-01 1.289380081300812997e-01 1.307164634146341375e-01 1.314786585365853577e-01 1.327489837398374006e-01 1.323678861788617767e-01 1.338922764227642170e-01 1.297002032520325199e-01 1.303353658536585413e-01 1.243648373983739785e-01 1.210619918699187003e-01 1.150914634146341514e-01
1.195376016260162599e-01 1.205538617886178915e-01 1.224593495934959281e-01 1.257621951219512202e-01 1.276676829268292568e-01 1.243648373983739785e-01 1.257621951219512202e-01 1.285569105691057035e-01 1.281758130081300795e-01 1.283028455284552782e-01 1.279217479674796820e-01 1.294461382113821224e-01 1.267784552845528379e-01 1.291920731707316972e-01 1.295731707317073211e-01 1.312245934959349603e-01 1.277947154471544833e-01 1.262703252032520429e-01 1.244918699186991912e-01 1.181402439024390183e-01 1.128048780487804909e-01
1.246189024390243899e-01 1.251270325203251987e-01 1.277947154471544833e-01 1.274136178861788593e-01 1.298272357723577186e-01 1.283028455284552782e-01 1.288109756097561009e-01 1.303353658536585413e-01 1.310975609756097615e-01 1.299542682926829174e-01 1.289380081300812997e-01 1.271595528455284618e-01 1.261432926829268164e-01 1.277947154471544833e-01 1.297002032520325199e-01 1.293191056910569237e-01 1.261432926829268164e-01 1.252540650406503975e-01 1.201727642276422814e-01 1.134400406504064984e-01 1.064532520325203319e-01
1.248729674796748013e-01 1.291920731707316972e-01 1.305894308943089388e-01 1.314786585365853577e-01 1.326219512195122019e-01 1.299542682926829174e-01 1.289380081300812997e-01 1.294461382113821224e-01 1.290650406504064984e-01 1.285569105691057035e-01 1.276676829268292568e-01 1.274136178861788593e-01 1.252540650406503975e-01 1.251270325203251987e-01 1.270325203252032631e-01 1.265243902439024404e-01 1.241107723577235811e-01 1.220782520325203319e-01 1.183943089430894297e-01 1.098831300813008088e-01 1.004827235772357691e-01
1.274136178861788593e-01 1.321138211382113792e-01 1.336382113821138196e-01 1.332571138211382233e-01 1.342733739837398410e-01 1.319867886178861804e-01 1.318597560975609817e-01 1.293191056910569237e-01 1.297002032520325199e-01 1.309705284552845628e-01 1.308434959349593363e-01 1.279217479674796820e-01 1.256351626016260215e-01 1.237296747967479710e-01 1.242378048780487798e-01 1.241107723577235811e-01 1.241107723577235811e-01 1.189024390243902385e-01 1.128048780487804909e-01 1.091209349593495886e-01 1.002286585365853716e-01
1.276676829268292568e-01 1.337652439024390183e-01 1.350355691056910612e-01 1.333841463414634221e-01 1.341463414634146423e-01 1.310975609756097615e-01 1.330030487804877981e-01 1.310975609756097615e-01 1.317327235772357830e-01 1.295731707317073211e-01 1.305894308943089388e-01 1.275406504065040580e-01 1.242378048780487798e-01 1.230945121951219495e-01 1.230945121951219495e-01 1.225863821138211407e-01 1.196646341463414587e-01 1.166158536585365918e-01 1.116615853658536606e-01 1.053099593495935016e-01 9.806910569105690978e-02
1.265243902439024404e-01 1.297002032520325199e-01 1.336382113821138196e-01 1.307164634146341375e-01 1.346544715447154372e-01 1.308434959349593363e-01 1.322408536585365779e-01 1.300813008130081438e-01 1.312245934959349603e-01 1.295731707317073211e-01 1.283028455284552782e-01 1.256351626016260215e-01 1.242378048780487798e-01 1.230945121951219495e-01 1.194105691056910612e-01 1.173780487804877981e-01 1.148373983739837401e-01 1.135670731707317110e-01 1.068343495934959281e-01 1.011178861788617905e-01 9.616361788617885931e-02
1.244918699186991912e-01 1.297002032520325199e-01 1.308434959349593363e-01 1.324949186991870032e-01 1.323678861788617767e-01 1.327489837398374006e-01 1.288109756097561009e-01 1.330030487804877981e-01 1.318597560975609817e-01 1.294461382113821224e-01 1.262703252032520429e-01 1.251270325203251987e-01 1.225863821138211407e-01 1.219512195121951192e-01 1.197916666666666713e-01 1.185213414634146284e-01 1.145833333333333287e-01 1.117886178861788593e-01 1.059451219512195091e-01 9.933943089430893880e-02 9.438516260162602145e-02
1.243648373983739785e-01 1.275406504065040580e-01 1.297002032520325199e-01 1.322408536585365779e-01 1.321138211382113792e-01 1.299542682926829174e-01 1.304623983739837401e-01 1.302083333333333426e-01 1.300813008130081438e-01 1.269054878048780366e-01 1.253810975609755962e-01 1.228404471544715382e-01 1.190294715447154511e-01 1.196646341463414587e-01 1.152184959349593502e-01 1.143292682926829312e-01 1.091209349593495886e-01 1.055640243902438991e-01 1.018800813008130107e-01 9.514735772357724164e-02 9.108231707317072934e-02
1.223323170731707293e-01 1.266514227642276391e-01 1.286839430894309022e-01 1.293191056910569237e-01 1.298272357723577186e-01 1.284298780487804770e-01 1.272865853658536606e-01 1.262703252032520429e-01 1.279217479674796820e-01 1.253810975609755962e-01 1.241107723577235811e-01 1.209349593495935016e-01 1.159806910569105703e-01 1.124237804878048808e-01 1.120426829268292707e-01 1.084857723577235811e-01 1.058180894308943104e-01 1.014989837398374006e-01 9.502032520325202902e-02 9.057418699186992050e-02 8.638211382113820946e-02
1.225863821138211407e-01 1.256351626016260215e-01 1.267784552845528379e-01 1.281758130081300795e-01 1.261432926829268164e-01 1.265243902439024404e-01 1.255081300813008227e-01 1.242378048780487798e-01 1.218241869918699205e-01 1.202997967479674801e-01 1.164888211382113792e-01 1.164888211382113792e-01 1.119156504065040719e-01 1.101371951219512202e-01 1.087398373983739785e-01 1.056910569105691117e-01 1.014989837398374006e-01 9.679878048780488076e-02 8.765243902439023849e-02 8.523882113821137918e-02 8.269817073170732113e-02
1.200457317073170688e-01 1.224593495934959281e-01 1.224593495934959281e-01 1.214430894308943104e-01 1.190294715447154511e-01 1.177591463414634082e-01 1.176321138211382095e-01 1.186483739837398410e-01 1.155995934959349603e-01 1.110264227642276391e-01 1.130589430894308883e-01 1.107723577235772416e-01 1.058180894308943104e-01 1.050558943089430902e-01 1.009908536585365918e-01 9.832317073170732113e-02 9.336890243902438991e-02 9.044715447154472177e-02 8.447662601626015899e-02 8.180894308943088833e-02 7.812500000000000000e-02
1.163617886178861804e-01 1.192835365853658486e-01 1.173780487804877981e-01 1.147103658536585413e-01 1.143292682926829312e-01 1.125508130081300795e-01 1.108993902439024404e-01 1.100101626016260215e-01 1.078506097560975596e-01 1.049288617886178915e-01 1.064532520325203319e-01 1.042936991869918700e-01 1.017530487804877981e-01 9.895833333333332871e-02 9.565548780487805047e-02 9.171747967479675079e-02 8.816056910569106120e-02 8.409552845528454890e-02 8.193597560975610095e-02 7.634654471544714827e-02 7.558434959349592808e-02
