1.143170197224251255e-01 1.115777940102264387e-01 1.112125639152666129e-01 1.128560993425858222e-01 1.071950328707085426e-01 1.059167275383491591e-01 1.050036523009496015e-01 1.070124178232286366e-01 1.101168736303871493e-01 1.124908692476260103e-01 1.115777940102264387e-01 1.154127100073046031e-01 1.179693206720233700e-01 1.170562454346238124e-01 1.192476260043827674e-01 1.192476260043827674e-01 1.203433162892622310e-01 1.181519357195032899e-01 1.165084002921840806e-01 1.126734842951059162e-01 1.057341124908692531e-01
1.113951789627465327e-01 1.090211833455076718e-01 1.106647187728268811e-01 1.113951789627465327e-01 1.110299488677867069e-01 1.095690284879474036e-01 1.075602629656683684e-01 1.112125639152666129e-01 1.132213294375456480e-01 1.185171658144631157e-01 1.203433162892622310e-01 1.212563915266618025e-01 1.210737764791818827e-01 1.208911614317019767e-01 1.254565376186997927e-01 1.249086924762600470e-01 1.247260774287801272e-01 1.230825420014609178e-01 1.177867056245434640e-01 1.150474799123447772e-01 1.117604090577063586e-01
1.090211833455076718e-01 1.081081081081081141e-01 1.104821037253469751e-01 1.141344046749452196e-01 1.110299488677867069e-01 1.121256391526661844e-01 1.137691745799853937e-01 1.157779401022644289e-01 1.176040905770635442e-01 1.212563915266618025e-01 1.232651570489408377e-01 1.249086924762600470e-01 1.249086924762600470e-01 1.265522279035792563e-01 1.281957633308984656e-01 1.289262235208181173e-01 1.287436084733382113e-01 1.252739225712198590e-01 1.223520818115412662e-01 1.170562454346238124e-01 1.124908692476260103e-01
1.112125639152666129e-01 1.108473338203067871e-01 1.152300949598246832e-01 1.168736303871439064e-01 1.144996347699050454e-01 1.176040905770635442e-01 1.172388604821037322e-01 1.199780861943024052e-01 1.239956172388604755e-01 1.250913075237399530e-01 1.256391526661796987e-01 1.258217677136596047e-01 1.250913075237399530e-01 1.302045288531775147e-01 1.316654492330167903e-01 1.307523739956172326e-01 1.313002191380569783e-01 1.323959094229364419e-01 1.258217677136596047e-01 1.194302410518626734e-01 1.163257852447041607e-01
1.134039444850255679e-01 1.119430241051862646e-01 1.174214755295836382e-01 1.190650109569028475e-01 1.205259313367421509e-01 1.225346968590211860e-01 1.228999269539810119e-01 1.247260774287801272e-01 1.261869978086194166e-01 1.274653031409788140e-01 1.256391526661796987e-01 1.274653031409788140e-01 1.289262235208181173e-01 1.313002191380569783e-01 1.336742147552958393e-01 1.320306793279766300e-01 1.353177501826150486e-01 1.345872899926953969e-01 1.263696128560993504e-01 1.221694667640613602e-01 1.174214755295836382e-01
1.128560993425858222e-01 1.177867056245434640e-01 1.201607012417823250e-01 1.254565376186997927e-01 1.263696128560993504e-01 1.292914536157779293e-01 1.303871439006574207e-01 1.309349890430971386e-01 1.309349890430971386e-01 1.353177501826150486e-01 1.360482103725347003e-01 1.345872899926953969e-01 1.353177501826150486e-01 1.365960555149744460e-01 1.353177501826150486e-01 1.360482103725347003e-01 1.371439006574141639e-01 1.355003652300949546e-01 1.296566837107377690e-01 1.258217677136596047e-01 1.186997808619430217e-01
1.119430241051862646e-01 1.174214755295836382e-01 1.203433162892622310e-01 1.256391526661796987e-01 1.261869978086194166e-01 1.303871439006574207e-01 1.298392987582176750e-01 1.349525200876552367e-01 1.347699050401753029e-01 1.365960555149744460e-01 1.384222059897735613e-01 1.391526661796932129e-01 1.367786705624543520e-01 1.356829802775748606e-01 1.382395909422936553e-01 1.365960555149744460e-01 1.356829802775748606e-01 1.355003652300949546e-01 1.331263696128560936e-01 1.278305332359386537e-01 1.174214755295836382e-01
1.126734842951059162e-01 1.166910153396639865e-01 1.230825420014609178e-01 1.285609934258582776e-01 1.281957633308984656e-01 1.318480642804967240e-01 1.338568298027757453e-01 1.367786705624543520e-01 1.373265157048940699e-01 1.376917457998539096e-01 1.389700511322133070e-01 1.395178962746530249e-01 1.347699050401753029e-01 1.397005113221329309e-01 1.413440467494521680e-01 1.380569758948137216e-01 1.356829802775748606e-01 1.345872899926953969e-01 1.320306793279766300e-01 1.258217677136596047e-01 1.197954711468224992e-01
1.132213294375456480e-01 1.181519357195032899e-01 1.225346968590211860e-01 1.296566837107377690e-01 1.289262235208181173e-01 1.355003652300949546e-01 1.369612856099342579e-01 1.378743608473338156e-01 1.400657414170927706e-01 1.402483564645726766e-01 1.415266617969320739e-01 1.397005113221329309e-01 1.371439006574141639e-01 1.387874360847333732e-01 1.400657414170927706e-01 1.391526661796932129e-01 1.386048210372534673e-01 1.356829802775748606e-01 1.325785244704163757e-01 1.260043827611395106e-01 1.186997808619430217e-01
1.141344046749452196e-01 1.214390065741417085e-01 1.234477720964207437e-01 1.276479181884587200e-01 1.302045288531775147e-01 1.340394448502556513e-01 1.358655953250547943e-01 1.384222059897735613e-01 1.395178962746530249e-01 1.413440467494521680e-01 1.397005113221329309e-01 1.409788166544923282e-01 1.393352812271731189e-01 1.382395909422936553e-01 1.380569758948137216e-01 1.386048210372534673e-01 1.398831263696128646e-01 1.378743608473338156e-01 1.323959094229364419e-01 1.250913075237399530e-01 1.166910153396639865e-01
1.139517896274652997e-01 1.192476260043827674e-01 1.225346968590211860e-01 1.278305332359386537e-01 1.309349890430971386e-01 1.336742147552958393e-01 1.391526661796932129e-01 1.384222059897735613e-01 1.387874360847333732e-01 1.386048210372534673e-01 1.397005113221329309e-01 1.398831263696128646e-01 1.382395909422936553e-01 1.347699050401753029e-01 1.355003652300949546e-01 1.360482103725347003e-01 1.364134404674945122e-01 1.342220598977355850e-01 1.305697589481373266e-01 1.208911614317019767e-01 1.130387143900657421e-01
1.126734842951059162e-01 1.203433162892622310e-01 1.227173119065010920e-01 1.285609934258582776e-01 1.309349890430971386e-01 1.325785244704163757e-01 1.400657414170927706e-01 1.404309715120525826e-01 1.369612856099342579e-01 1.391526661796932129e-01 1.387874360847333732e-01 1.386048210372534673e-01 1.375091307523740036e-01 1.345872899926953969e-01 1.344046749452154910e-01 1.345872899926953969e-01 1.358655953250547943e-01 1.316654492330167903e-01 1.250913075237399530e-01 1.197954711468224992e-01 1.130387143900657421e-01
1.124908692476260103e-01 1.196128560993425793e-01 1.223520818115412662e-01 1.278305332359386537e-01 1.307523739956172326e-01 1.344046749452154910e-01 1.386048210372534673e-01 1.378743608473338156e-01 1.409788166544923282e-01 1.404309715120525826e-01 1.375091307523740036e-01 1.360482103725347003e-01 1.356829802775748606e-01 1.334915997078159333e-01 1.349525200876552367e-01 1.311176040905770723e-01 1.316654492330167903e-01 1.292914536157779293e-01 1.203433162892622310e-01 1.152300949598246832e-01 1.093864134404674976e-01
1.113951789627465327e-01 1.183345507669831959e-01 1.221694667640613602e-01 1.281957633308984656e-01 1.294740686632578630e-01 1.311176040905770723e-01 1.325785244704163757e-01 1.393352812271731189e-01 1.397005113221329309e-01 1.418918918918918859e-01 1.389700511322133070e-01 1.369612856099342579e-01 1.333089846603359996e-01 1.338568298027757453e-01 1.353177501826150486e-01 1.336742147552958393e-01 1.325785244704163757e-01 1.236303871439006635e-01 1.245434623813002212e-01 1.126734842951059162e-01 1.082907231555880201e-01
1.135865595325054739e-01 1.201607012417823250e-01 1.214390065741417085e-01 1.265522279035792563e-01 1.285609934258582776e-01 1.340394448502556513e-01 1.375091307523740036e-01 1.376917457998539096e-01 1.386048210372534673e-01 1.393352812271731189e-01 1.400657414170927706e-01 1.411614317019722342e-01 1.378743608473338156e-01 1.340394448502556513e-01 1.331263696128560936e-01 1.316654492330167903e-01 1.302045288531775147e-01 1.223520818115412662e-01 1.197954711468224992e-01 1.117604090577063586e-01 1.062819576333089849e-01
1.135865595325054739e-01 1.179693206720233700e-01 1.203433162892622310e-01 1.271000730460190020e-01 1.294740686632578630e-01 1.307523739956172326e-01 1.355003652300949546e-01 1.386048210372534673e-01 1.395178962746530249e-01 1.386048210372534673e-01 1.364134404674945122e-01 1.373265157048940699e-01 1.345872899926953969e-01 1.327611395178962816e-01 1.294740686632578630e-01 1.289262235208181173e-01 1.280131482834185597e-01 1.221694667640613602e-01 1.166910153396639865e-01 1.095690284879474036e-01 1.042731921110299498e-01
1.123082542001460904e-01 1.174214755295836382e-01 1.221694667640613602e-01 1.269174579985390683e-01 1.289262235208181173e-01 1.314828341855368843e-01 1.376917457998539096e-01 1.384222059897735613e-01 1.391526661796932129e-01 1.382395909422936553e-01 1.358655953250547943e-01 1.358655953250547943e-01 1.325785244704163757e-01 1.302045288531775147e-01 1.307523739956172326e-01 1.269174579985390683e-01 1.245434623813002212e-01 1.205259313367421509e-01 1.176040905770635442e-01 1.070124178232286366e-01 1.009861212563915311e-01
1.110299488677867069e-01 1.139517896274652997e-01 1.190650109569028475e-01 1.247260774287801272e-01 1.261869978086194166e-01 1.271000730460190020e-01 1.331263696128560936e-01 1.365960555149744460e-01 1.378743608473338156e-01 1.353177501826150486e-01 1.327611395178962816e-01 1.327611395178962816e-01 1.298392987582176750e-01 1.254565376186997927e-01 1.269174579985390683e-01 1.223520818115412662e-01 1.194302410518626734e-01 1.132213294375456480e-01 1.108473338203067871e-01 1.046384222059897756e-01 9.368151935719502832e-02
1.075602629656683684e-01 1.110299488677867069e-01 1.174214755295836382e-01 1.207085463842220568e-01 1.239956172388604755e-01 1.238130021913805695e-01 1.292914536157779293e-01 1.309349890430971386e-01 1.307523739956172326e-01 1.305697589481373266e-01 1.263696128560993504e-01 1.283783783783783716e-01 1.245434623813002212e-01 1.201607012417823250e-01 1.194302410518626734e-01 1.148648648648648712e-01 1.099342585829072294e-01 1.050036523009496015e-01 1.004382761139517855e-01 9.806428049671292446e-02 9.185536888239591302e-02
1.050036523009496015e-01 1.095690284879474036e-01 1.152300949598246832e-01 1.194302410518626734e-01 1.203433162892622310e-01 1.197954711468224992e-01 1.238130021913805695e-01 1.249086924762600470e-01 1.254565376186997927e-01 1.236303871439006635e-01 1.201607012417823250e-01 1.207085463842220568e-01 1.188823959094229415e-01 1.157779401022644289e-01 1.128560993425858222e-01 1.073776479181884624e-01 1.026296566837107405e-01 9.970781592403213378e-02 9.459459459459459985e-02 8.856829802775748051e-02 8.382030679327977241e-02
1.044558071585098558e-01 1.086559532505478459e-01 1.106647187728268811e-01 1.174214755295836382e-01 1.185171658144631157e-01 1.161431701972242547e-01 1.165084002921840806e-01 1.168736303871439064e-01 1.170562454346238124e-01 1.150474799123447772e-01 1.143170197224251255e-01 1.128560993425858222e-01 1.102994886778670552e-01 1.057341124908692531e-01 1.029948867786705663e-01 1.004382761139517855e-01 9.623813002191380916e-02 9.112490869247626135e-02 8.655953250547844535e-02 8.327246165084002671e-02 7.888970051132213057e-02
