1.030207787672428876e-01 1.061637855770909689e-01 1.052907281299109432e-01 1.052907281299109432e-01 1.017984983411908545e-01 9.673476514754671129e-02 9.202025493277457557e-02 8.643268727082241421e-02 8.503579535533438427e-02 8.451196088702636611e-02 8.416273790815435862e-02 9.114719748559454993e-02 9.690937663698270810e-02 1.037192247249869026e-01 1.079099004714510202e-01 1.136720796228391783e-01 1.178627553693032959e-01 1.189104243059193322e-01 1.197834817530993579e-01 1.168150864326872734e-01 1.148943600488912115e-01
1.061637855770909689e-01 1.080845119608870308e-01 1.093067923869390640e-01 1.086083464291950351e-01 1.059891740876549721e-01 1.004016064257028107e-01 9.725859961585472946e-02 9.254408940108259374e-02 9.149642046446655741e-02 9.114719748559454993e-02 9.254408940108259374e-02 9.638554216867470381e-02 1.031953902566788844e-01 1.094814038763750608e-01 1.133228566439671708e-01 1.187358128164833215e-01 1.239741574995634754e-01 1.255456609044875160e-01 1.260694953727955203e-01 1.215295966474594092e-01 1.166404749432512628e-01
1.045922821721669282e-01 1.070368430242709945e-01 1.112275187707351121e-01 1.114021302601711227e-01 1.079099004714510202e-01 1.016238868517548438e-01 1.014492753623188470e-01 1.004016064257028107e-01 9.533787323205866748e-02 9.970316046795879572e-02 9.883010302077877007e-02 1.024969442989348695e-01 1.073860660031430020e-01 1.150689715383272221e-01 1.178627553693032959e-01 1.255456609044875160e-01 1.286886677143355973e-01 1.292125021826436293e-01 1.292125021826436293e-01 1.246726034573074904e-01 1.204819277108433728e-01
1.030207787672428876e-01 1.112275187707351121e-01 1.147197485594552147e-01 1.157674174960712371e-01 1.122751877073511484e-01 1.070368430242709945e-01 1.021477213200628620e-01 1.049415051510389357e-01 1.042430591932949208e-01 1.049415051510389357e-01 1.047668936616029389e-01 1.072114545137070052e-01 1.138466911122751890e-01 1.164658634538152659e-01 1.220534311157674134e-01 1.255456609044875160e-01 1.311332285664396635e-01 1.290378906932076186e-01 1.292125021826436293e-01 1.265933298411035524e-01 1.236249345206914679e-01
1.009254408940108289e-01 1.066876200453989870e-01 1.140213026017111858e-01 1.141959140911471965e-01 1.115767417496071195e-01 1.082591234503230276e-01 1.075606774925790127e-01 1.052907281299109432e-01 1.082591234503230276e-01 1.089575694080670565e-01 1.093067923869390640e-01 1.122751877073511484e-01 1.161166404749432446e-01 1.218788196263314166e-01 1.234503230312554573e-01 1.290378906932076186e-01 1.302601711192596379e-01 1.299109481403876443e-01 1.279902217565915823e-01 1.253710494150515053e-01 1.253710494150515053e-01
1.005762179151388214e-01 1.038938362144229133e-01 1.093067923869390640e-01 1.110529072812991153e-01 1.108782957918631046e-01 1.098306268552470821e-01 1.075606774925790127e-01 1.056399511087829646e-01 1.091321808975030533e-01 1.112275187707351121e-01 1.136720796228391783e-01 1.131482451545311740e-01 1.154181945171992296e-01 1.215295966474594092e-01 1.229264885629474391e-01 1.276409987777195609e-01 1.299109481403876443e-01 1.272917757988475673e-01 1.285140562248995866e-01 1.253710494150515053e-01 1.258948838833595374e-01
9.324253535882660870e-02 1.016238868517548438e-01 1.054653396193469539e-01 1.094814038763750608e-01 1.121005762179151377e-01 1.103544613235550864e-01 1.107036843024270939e-01 1.089575694080670565e-01 1.075606774925790127e-01 1.107036843024270939e-01 1.110529072812991153e-01 1.138466911122751890e-01 1.141959140911471965e-01 1.192596472847913397e-01 1.225772655840754316e-01 1.265933298411035524e-01 1.269425528199755460e-01 1.283394447354636037e-01 1.300855596298236549e-01 1.276409987777195609e-01 1.250218264361795117e-01
9.324253535882660870e-02 9.673476514754671129e-02 1.021477213200628620e-01 1.059891740876549721e-01 1.110529072812991153e-01 1.112275187707351121e-01 1.100052383446830789e-01 1.089575694080670565e-01 1.096560153658110714e-01 1.108782957918631046e-01 1.117513532390431302e-01 1.136720796228391783e-01 1.140213026017111858e-01 1.175135323904312884e-01 1.215295966474594092e-01 1.264187183516675417e-01 1.253710494150515053e-01 1.272917757988475673e-01 1.269425528199755460e-01 1.260694953727955203e-01 1.213549851580233985e-01
9.044875152785053496e-02 9.656015365811070061e-02 1.002269949362668000e-01 1.068622315348349977e-01 1.121005762179151377e-01 1.108782957918631046e-01 1.103544613235550864e-01 1.065130085559629763e-01 1.080845119608870308e-01 1.105290728129910971e-01 1.119259647284791270e-01 1.124497991967871452e-01 1.150689715383272221e-01 1.148943600488912115e-01 1.194342587742273504e-01 1.208311506897153803e-01 1.218788196263314166e-01 1.231011000523834498e-01 1.231011000523834498e-01 1.203073162214073621e-01 1.182119783481753034e-01
9.079797450672254244e-02 9.446481578487864184e-02 1.002269949362668000e-01 1.051161166404749464e-01 1.107036843024270939e-01 1.100052383446830789e-01 1.080845119608870308e-01 1.068622315348349977e-01 1.056399511087829646e-01 1.093067923869390640e-01 1.093067923869390640e-01 1.098306268552470821e-01 1.119259647284791270e-01 1.136720796228391783e-01 1.143705255805832072e-01 1.175135323904312884e-01 1.182119783481753034e-01 1.187358128164833215e-01 1.203073162214073621e-01 1.185612013270473247e-01 1.126244106862231559e-01
9.167103195390256809e-02 9.551248472149467816e-02 1.016238868517548438e-01 1.068622315348349977e-01 1.140213026017111858e-01 1.131482451545311740e-01 1.117513532390431302e-01 1.070368430242709945e-01 1.049415051510389357e-01 1.087829579186310458e-01 1.089575694080670565e-01 1.100052383446830789e-01 1.105290728129910971e-01 1.114021302601711227e-01 1.108782957918631046e-01 1.117513532390431302e-01 1.140213026017111858e-01 1.164658634538152659e-01 1.150689715383272221e-01 1.112275187707351121e-01 1.082591234503230276e-01
9.271870089051859054e-02 1.009254408940108289e-01 1.093067923869390640e-01 1.129736336650951634e-01 1.175135323904312884e-01 1.173389209009952916e-01 1.159420289855072478e-01 1.119259647284791270e-01 1.087829579186310458e-01 1.117513532390431302e-01 1.096560153658110714e-01 1.091321808975030533e-01 1.089575694080670565e-01 1.110529072812991153e-01 1.110529072812991153e-01 1.136720796228391783e-01 1.126244106862231559e-01 1.131482451545311740e-01 1.124497991967871452e-01 1.105290728129910971e-01 1.026715557883708801e-01
1.000523834468308032e-01 1.089575694080670565e-01 1.121005762179151377e-01 1.189104243059193322e-01 1.204819277108433728e-01 1.175135323904312884e-01 1.148943600488912115e-01 1.155928060066352403e-01 1.138466911122751890e-01 1.110529072812991153e-01 1.117513532390431302e-01 1.101798498341190896e-01 1.114021302601711227e-01 1.133228566439671708e-01 1.121005762179151377e-01 1.110529072812991153e-01 1.124497991967871452e-01 1.129736336650951634e-01 1.108782957918631046e-01 1.082591234503230276e-01 1.019731098306268513e-01
1.066876200453989870e-01 1.143705255805832072e-01 1.178627553693032959e-01 1.210057621791513910e-01 1.224026540946394209e-01 1.220534311157674134e-01 1.211803736685873878e-01 1.192596472847913397e-01 1.175135323904312884e-01 1.141959140911471965e-01 1.119259647284791270e-01 1.119259647284791270e-01 1.150689715383272221e-01 1.140213026017111858e-01 1.143705255805832072e-01 1.161166404749432446e-01 1.136720796228391783e-01 1.143705255805832072e-01 1.114021302601711227e-01 1.075606774925790127e-01 1.033700017461148951e-01
1.093067923869390640e-01 1.175135323904312884e-01 1.203073162214073621e-01 1.241487689889994722e-01 1.224026540946394209e-01 1.229264885629474391e-01 1.227518770735114423e-01 1.210057621791513910e-01 1.183865898376113140e-01 1.148943600488912115e-01 1.124497991967871452e-01 1.131482451545311740e-01 1.157674174960712371e-01 1.175135323904312884e-01 1.176881438798672991e-01 1.189104243059193322e-01 1.178627553693032959e-01 1.176881438798672991e-01 1.159420289855072478e-01 1.103544613235550864e-01 1.047668936616029389e-01
1.164658634538152659e-01 1.215295966474594092e-01 1.241487689889994722e-01 1.251964379256154947e-01 1.264187183516675417e-01 1.257202723939235267e-01 1.290378906932076186e-01 1.232757115418194466e-01 1.218788196263314166e-01 1.176881438798672991e-01 1.173389209009952916e-01 1.161166404749432446e-01 1.189104243059193322e-01 1.183865898376113140e-01 1.208311506897153803e-01 1.227518770735114423e-01 1.194342587742273504e-01 1.189104243059193322e-01 1.185612013270473247e-01 1.107036843024270939e-01 1.042430591932949208e-01
1.187358128164833215e-01 1.231011000523834498e-01 1.253710494150515053e-01 1.278156102671555716e-01 1.295617251615156229e-01 1.257202723939235267e-01 1.274663872882835780e-01 1.231011000523834498e-01 1.224026540946394209e-01 1.192596472847913397e-01 1.176881438798672991e-01 1.150689715383272221e-01 1.178627553693032959e-01 1.173389209009952916e-01 1.190850357953553290e-01 1.213549851580233985e-01 1.190850357953553290e-01 1.196088702636633472e-01 1.211803736685873878e-01 1.143705255805832072e-01 1.080845119608870308e-01
1.206565392002793835e-01 1.246726034573074904e-01 1.276409987777195609e-01 1.278156102671555716e-01 1.295617251615156229e-01 1.283394447354636037e-01 1.267679413305395630e-01 1.224026540946394209e-01 1.239741574995634754e-01 1.194342587742273504e-01 1.182119783481753034e-01 1.141959140911471965e-01 1.154181945171992296e-01 1.161166404749432446e-01 1.162912519643792553e-01 1.166404749432512628e-01 1.176881438798672991e-01 1.210057621791513910e-01 1.217042081368954060e-01 1.152435830277632328e-01 1.107036843024270939e-01
1.204819277108433728e-01 1.213549851580233985e-01 1.239741574995634754e-01 1.265933298411035524e-01 1.258948838833595374e-01 1.255456609044875160e-01 1.231011000523834498e-01 1.196088702636633472e-01 1.213549851580233985e-01 1.192596472847913397e-01 1.136720796228391783e-01 1.105290728129910971e-01 1.115767417496071195e-01 1.112275187707351121e-01 1.101798498341190896e-01 1.141959140911471965e-01 1.157674174960712371e-01 1.166404749432512628e-01 1.206565392002793835e-01 1.117513532390431302e-01 1.047668936616029389e-01
1.183865898376113140e-01 1.211803736685873878e-01 1.215295966474594092e-01 1.244979919678714797e-01 1.265933298411035524e-01 1.236249345206914679e-01 1.222280426052034241e-01 1.183865898376113140e-01 1.162912519643792553e-01 1.124497991967871452e-01 1.080845119608870308e-01 1.038938362144229133e-01 1.023223328094988588e-01 1.038938362144229133e-01 1.047668936616029389e-01 1.093067923869390640e-01 1.094814038763750608e-01 1.089575694080670565e-01 1.079099004714510202e-01 1.033700017461148951e-01 9.586170770036668565e-02
1.173389209009952916e-01 1.203073162214073621e-01 1.204819277108433728e-01 1.220534311157674134e-01 1.224026540946394209e-01 1.201327047319713653e-01 1.173389209009952916e-01 1.133228566439671708e-01 1.096560153658110714e-01 1.068622315348349977e-01 1.023223328094988588e-01 9.481403876375064932e-02 9.516326174262267068e-02 9.516326174262267068e-02 9.603631918980268245e-02 1.014492753623188470e-01 1.011000523834468257e-01 1.017984983411908545e-01 1.011000523834468257e-01 9.533787323205866748e-02 9.079797450672254244e-02
