1.237044910975285683e-01 1.229072548498538336e-01 1.235716183895827769e-01 1.201169279829922970e-01 1.154663832048897221e-01 1.088227478076003174e-01 1.036407121977145906e-01 1.003188944990698883e-01 9.925591283550358468e-02 1.004517672070156797e-01 1.052351846930640461e-01 1.122774382141908112e-01 1.155992559128354996e-01 1.209141642306670178e-01 1.275577996279564086e-01 1.296837629550890159e-01 1.310124900345469023e-01 1.292851448312516693e-01 1.276906723359022000e-01 1.256975817167153842e-01 1.211799096465586006e-01
1.234387456816369855e-01 1.256975817167153842e-01 1.272920542120648535e-01 1.219771458942333214e-01 1.161307467446186514e-01 1.112144565506245075e-01 1.056338028169014065e-01 1.037735849056603821e-01 1.037735849056603821e-01 1.043050757374435339e-01 1.114802019665160765e-01 1.187882009035344105e-01 1.207812915227212264e-01 1.246346000531490805e-01 1.310124900345469023e-01 1.346000531490831875e-01 1.327398352378421353e-01 1.315439808663300680e-01 1.291522721233058779e-01 1.275577996279564086e-01 1.267605633802816878e-01
1.218442731862875300e-01 1.246346000531490805e-01 1.241031092213659287e-01 1.222428913101249043e-01 1.177252192399681069e-01 1.105500930108955643e-01 1.078926388519798052e-01 1.037735849056603821e-01 1.033749667818230078e-01 1.062981663566303497e-01 1.121445655062450197e-01 1.174594738240765379e-01 1.229072548498538336e-01 1.284879085835769208e-01 1.323412171140047888e-01 1.334041987775710925e-01 1.368588891841615862e-01 1.335370714855168839e-01 1.315439808663300680e-01 1.296837629550890159e-01 1.259633271326069670e-01
1.183895827796970501e-01 1.197183098591549227e-01 1.206484188147754488e-01 1.195854371512091452e-01 1.145362742492691960e-01 1.081583842678713742e-01 1.072282753122508620e-01 1.051023119851182547e-01 1.037735849056603821e-01 1.061652936486845583e-01 1.106829657188413557e-01 1.165293648684560257e-01 1.225086367260164733e-01 1.279564177517937829e-01 1.323412171140047888e-01 1.342014350252458132e-01 1.342014350252458132e-01 1.330055806537337182e-01 1.339356896093542304e-01 1.302152537868721816e-01 1.251660908849322462e-01
1.129418017539197405e-01 1.154663832048897221e-01 1.163964921605102343e-01 1.158650013287270825e-01 1.116130746744618679e-01 1.078926388519798052e-01 1.065639117725219187e-01 1.039064576136061596e-01 1.043050757374435339e-01 1.045708211533351029e-01 1.106829657188413557e-01 1.171937284081849551e-01 1.207812915227212264e-01 1.256975817167153842e-01 1.283550358756311571e-01 1.323412171140047888e-01 1.334041987775710925e-01 1.339356896093542304e-01 1.315439808663300680e-01 1.278235450438479914e-01 1.237044910975285683e-01
1.121445655062450197e-01 1.121445655062450197e-01 1.137390380015944752e-01 1.116130746744618679e-01 1.082912569758171656e-01 1.055009301089556151e-01 1.039064576136061596e-01 1.051023119851182547e-01 1.057666755248471979e-01 1.048365665692266857e-01 1.097528567632208296e-01 1.132075471698113234e-01 1.171937284081849551e-01 1.227743821419080561e-01 1.271591815041190621e-01 1.310124900345469023e-01 1.338028169014084390e-01 1.340685623173000218e-01 1.302152537868721816e-01 1.264948179643901049e-01 1.221100186021791129e-01
1.098857294711666210e-01 1.106829657188413557e-01 1.101514748870582039e-01 1.089556205155461088e-01 1.082912569758171656e-01 1.098857294711666210e-01 1.056338028169014065e-01 1.084241296837629570e-01 1.066967844804677101e-01 1.080255115599255966e-01 1.114802019665160765e-01 1.161307467446186514e-01 1.183895827796970501e-01 1.223757640180706818e-01 1.274249269200106172e-01 1.315439808663300680e-01 1.338028169014084390e-01 1.342014350252458132e-01 1.295508902471432244e-01 1.225086367260164733e-01 1.190539463194259934e-01
1.058995482327929893e-01 1.074940207281424448e-01 1.081583842678713742e-01 1.069625298963592930e-01 1.064310390645761412e-01 1.048365665692266857e-01 1.080255115599255966e-01 1.082912569758171656e-01 1.105500930108955643e-01 1.078926388519798052e-01 1.112144565506245075e-01 1.138719107095402666e-01 1.157321286207812910e-01 1.198511825671007142e-01 1.250332181769864548e-01 1.291522721233058779e-01 1.320754716981132060e-01 1.327398352378421353e-01 1.280892904597395743e-01 1.241031092213659287e-01 1.203826733988838660e-01
1.045708211533351029e-01 1.082912569758171656e-01 1.112144565506245075e-01 1.106829657188413557e-01 1.070954026043050705e-01 1.081583842678713742e-01 1.094871113473292606e-01 1.100186021791124125e-01 1.117459473824076593e-01 1.120116927982992283e-01 1.129418017539197405e-01 1.146691469572149874e-01 1.181238373638054812e-01 1.197183098591549227e-01 1.227743821419080561e-01 1.259633271326069670e-01 1.308796173266011109e-01 1.324740898219505802e-01 1.268934360882274792e-01 1.239702365134201373e-01 1.182567100717512587e-01
1.058995482327929893e-01 1.076268934360882223e-01 1.109487111347329247e-01 1.096199840552750521e-01 1.078926388519798052e-01 1.073611480201966534e-01 1.094871113473292606e-01 1.092213659314376778e-01 1.073611480201966534e-01 1.094871113473292606e-01 1.116130746744618679e-01 1.141376561254318356e-01 1.158650013287270825e-01 1.162636194525644429e-01 1.221100186021791129e-01 1.241031092213659287e-01 1.263619452564443135e-01 1.258304544246611756e-01 1.227743821419080561e-01 1.171937284081849551e-01 1.118788200903534369e-01
1.066967844804677101e-01 1.132075471698113234e-01 1.133404198777571148e-01 1.126760563380281716e-01 1.150677650810523478e-01 1.117459473824076593e-01 1.116130746744618679e-01 1.101514748870582039e-01 1.105500930108955643e-01 1.100186021791124125e-01 1.118788200903534369e-01 1.146691469572149874e-01 1.181238373638054812e-01 1.173266011161307465e-01 1.197183098591549227e-01 1.225086367260164733e-01 1.226415094339622647e-01 1.234387456816369855e-01 1.199840552750465056e-01 1.161307467446186514e-01 1.062981663566303497e-01
1.108158384267871333e-01 1.128089290459739630e-01 1.161307467446186514e-01 1.177252192399681069e-01 1.174594738240765379e-01 1.157321286207812910e-01 1.141376561254318356e-01 1.142705288333776270e-01 1.144034015413234184e-01 1.145362742492691960e-01 1.142705288333776270e-01 1.179909646558596897e-01 1.185224554876428416e-01 1.189210736114802019e-01 1.199840552750465056e-01 1.227743821419080561e-01 1.215785277703959610e-01 1.243688546372575116e-01 1.197183098591549227e-01 1.144034015413234184e-01 1.070954026043050705e-01
1.140047834174860442e-01 1.209141642306670178e-01 1.209141642306670178e-01 1.221100186021791129e-01 1.195854371512091452e-01 1.199840552750465056e-01 1.197183098591549227e-01 1.177252192399681069e-01 1.187882009035344105e-01 1.163964921605102343e-01 1.181238373638054812e-01 1.199840552750465056e-01 1.210470369386128092e-01 1.199840552750465056e-01 1.246346000531490805e-01 1.218442731862875300e-01 1.210470369386128092e-01 1.214456550624501696e-01 1.186553281955886330e-01 1.140047834174860442e-01 1.069625298963592930e-01
1.183895827796970501e-01 1.238373638054743597e-01 1.259633271326069670e-01 1.255647090087695927e-01 1.267605633802816878e-01 1.249003454690406634e-01 1.238373638054743597e-01 1.206484188147754488e-01 1.205155461068296574e-01 1.213127823545043782e-01 1.198511825671007142e-01 1.219771458942333214e-01 1.207812915227212264e-01 1.230401275577996251e-01 1.258304544246611756e-01 1.229072548498538336e-01 1.219771458942333214e-01 1.211799096465586006e-01 1.159978740366728739e-01 1.142705288333776270e-01 1.066967844804677101e-01
1.255647090087695927e-01 1.272920542120648535e-01 1.291522721233058779e-01 1.300823810789263901e-01 1.276906723359022000e-01 1.267605633802816878e-01 1.252989635928780099e-01 1.241031092213659287e-01 1.221100186021791129e-01 1.237044910975285683e-01 1.225086367260164733e-01 1.218442731862875300e-01 1.245017273452032891e-01 1.263619452564443135e-01 1.280892904597395743e-01 1.268934360882274792e-01 1.251660908849322462e-01 1.217114004783417525e-01 1.186553281955886330e-01 1.134732925857028923e-01 1.057666755248471979e-01
1.276906723359022000e-01 1.288865267074142951e-01 1.312782354504384852e-01 1.308796173266011109e-01 1.295508902471432244e-01 1.295508902471432244e-01 1.271591815041190621e-01 1.259633271326069670e-01 1.252989635928780099e-01 1.225086367260164733e-01 1.233058729736912079e-01 1.233058729736912079e-01 1.222428913101249043e-01 1.259633271326069670e-01 1.250332181769864548e-01 1.250332181769864548e-01 1.226415094339622647e-01 1.197183098591549227e-01 1.186553281955886330e-01 1.121445655062450197e-01 1.036407121977145906e-01
1.295508902471432244e-01 1.315439808663300680e-01 1.334041987775710925e-01 1.339356896093542304e-01 1.315439808663300680e-01 1.307467446186553195e-01 1.296837629550890159e-01 1.270263087961732706e-01 1.258304544246611756e-01 1.235716183895827769e-01 1.239702365134201373e-01 1.229072548498538336e-01 1.226415094339622647e-01 1.242359819293117201e-01 1.238373638054743597e-01 1.235716183895827769e-01 1.229072548498538336e-01 1.205155461068296574e-01 1.178580919479138983e-01 1.124103109221365887e-01 1.027106032420940784e-01
1.300823810789263901e-01 1.315439808663300680e-01 1.323412171140047888e-01 1.340685623173000218e-01 1.335370714855168839e-01 1.307467446186553195e-01 1.278235450438479914e-01 1.262290725484985499e-01 1.245017273452032891e-01 1.233058729736912079e-01 1.194525644432633538e-01 1.197183098591549227e-01 1.213127823545043782e-01 1.238373638054743597e-01 1.238373638054743597e-01 1.226415094339622647e-01 1.231730002657454165e-01 1.211799096465586006e-01 1.166622375764018033e-01 1.106829657188413557e-01 9.899016741961201571e-02
1.308796173266011109e-01 1.292851448312516693e-01 1.319425989901674146e-01 1.314111081583842766e-01 1.306138719107095281e-01 1.291522721233058779e-01 1.278235450438479914e-01 1.267605633802816878e-01 1.234387456816369855e-01 1.194525644432633538e-01 1.181238373638054812e-01 1.171937284081849551e-01 1.191868190273717709e-01 1.223757640180706818e-01 1.201169279829922970e-01 1.209141642306670178e-01 1.201169279829922970e-01 1.163964921605102343e-01 1.129418017539197405e-01 1.053680574010098375e-01 9.726282221631676883e-02
1.275577996279564086e-01 1.266276906723358964e-01 1.299495083709805987e-01 1.300823810789263901e-01 1.306138719107095281e-01 1.296837629550890159e-01 1.272920542120648535e-01 1.242359819293117201e-01 1.207812915227212264e-01 1.157321286207812910e-01 1.137390380015944752e-01 1.125431836300823801e-01 1.145362742492691960e-01 1.165293648684560257e-01 1.173266011161307465e-01 1.165293648684560257e-01 1.133404198777571148e-01 1.110815838426787161e-01 1.068296571884135016e-01 1.000531490831783193e-01 9.327664097794313713e-02
1.251660908849322462e-01 1.251660908849322462e-01 1.264948179643901049e-01 1.274249269200106172e-01 1.250332181769864548e-01 1.238373638054743597e-01 1.218442731862875300e-01 1.190539463194259934e-01 1.158650013287270825e-01 1.098857294711666210e-01 1.086898750996545260e-01 1.062981663566303497e-01 1.078926388519798052e-01 1.101514748870582039e-01 1.109487111347329247e-01 1.097528567632208296e-01 1.058995482327929893e-01 1.039064576136061596e-01 9.832580387988307247e-02 9.367525910178049753e-02 8.875896890778633974e-02
