1.371918542336548752e-01 1.404072883172561570e-01 1.413004644515898633e-01 1.407645587709896451e-01 1.371918542336548752e-01 1.321900678813862084e-01 1.321900678813862084e-01 1.286173633440514386e-01 1.312968917470525299e-01 1.330832440157198870e-01 1.334405144694533751e-01 1.346909610575205418e-01 1.386209360485887720e-01 1.357627724187209783e-01 1.384423008217220419e-01 1.359414076455877085e-01 1.350482315112540299e-01 1.325473383351196965e-01 1.261164701679171052e-01 1.218292247231154007e-01 1.161128974633797717e-01
1.362986780993211966e-01 1.386209360485887720e-01 1.404072883172561570e-01 1.407645587709896451e-01 1.361200428724544387e-01 1.305823508395855537e-01 1.320114326545194783e-01 1.311182565201857719e-01 1.361200428724544387e-01 1.361200428724544387e-01 1.396927474097892086e-01 1.396927474097892086e-01 1.423722758127902721e-01 1.470167917113254785e-01 1.446945337620578753e-01 1.455877098963915817e-01 1.398713826366559387e-01 1.366559485530546569e-01 1.302250803858520933e-01 1.270096463022508115e-01 1.212933190425151825e-01
1.341550553769203236e-01 1.391568417291889903e-01 1.436227224008574388e-01 1.423722758127902721e-01 1.411218292247231054e-01 1.357627724187209783e-01 1.337977849231868632e-01 1.346909610575205418e-01 1.362986780993211966e-01 1.379063951411218236e-01 1.429081814933904904e-01 1.457663451232583118e-01 1.455877098963915817e-01 1.470167917113254785e-01 1.489817792068595936e-01 1.480886030725259150e-01 1.452304394426580936e-01 1.400500178635226967e-01 1.354055019649874902e-01 1.293319042515183870e-01 1.227224008574490932e-01
1.318327974276527204e-01 1.364773133261879268e-01 1.413004644515898633e-01 1.432654519471239785e-01 1.414790996784565935e-01 1.411218292247231054e-01 1.402286530903894268e-01 1.364773133261879268e-01 1.398713826366559387e-01 1.400500178635226967e-01 1.441586280814576571e-01 1.470167917113254785e-01 1.498749553411932722e-01 1.500535905680600302e-01 1.496963201143265421e-01 1.489817792068595936e-01 1.454090746695248237e-01 1.445158985351911451e-01 1.398713826366559387e-01 1.312968917470525299e-01 1.255805644873168869e-01
1.345123258306538117e-01 1.361200428724544387e-01 1.407645587709896451e-01 1.432654519471239785e-01 1.414790996784565935e-01 1.405859235441228872e-01 1.414790996784565935e-01 1.402286530903894268e-01 1.423722758127902721e-01 1.443372633083244150e-01 1.486245087531261055e-01 1.488031439799928635e-01 1.507681314755269786e-01 1.532690246516613120e-01 1.523758485173276056e-01 1.534476598785280421e-01 1.464808860307252603e-01 1.477313326187924269e-01 1.423722758127902721e-01 1.352268667381207601e-01 1.279028224365844901e-01
1.341550553769203236e-01 1.373704894605216054e-01 1.384423008217220419e-01 1.407645587709896451e-01 1.436227224008574388e-01 1.443372633083244150e-01 1.455877098963915817e-01 1.455877098963915817e-01 1.488031439799928635e-01 1.484458735262593754e-01 1.500535905680600302e-01 1.505894962486602484e-01 1.532690246516613120e-01 1.539835655591282604e-01 1.550553769203286969e-01 1.530903894247945818e-01 1.498749553411932722e-01 1.502322257949267603e-01 1.457663451232583118e-01 1.389782065023222601e-01 1.330832440157198870e-01
1.352268667381207601e-01 1.362986780993211966e-01 1.400500178635226967e-01 1.439799928545909269e-01 1.454090746695248237e-01 1.482672382993926452e-01 1.520185780635941453e-01 1.496963201143265421e-01 1.516613076098606572e-01 1.502322257949267603e-01 1.566630939621293239e-01 1.563058235083958636e-01 1.588067166845301970e-01 1.580921757770632485e-01 1.548767416934619390e-01 1.541622007859949905e-01 1.500535905680600302e-01 1.495176848874598119e-01 1.463022508038585301e-01 1.405859235441228872e-01 1.350482315112540299e-01
1.339764201500535934e-01 1.355841371918542204e-01 1.405859235441228872e-01 1.454090746695248237e-01 1.461236155769917722e-01 1.479099678456591571e-01 1.491604144337263238e-01 1.513040371561271968e-01 1.554126473740621572e-01 1.559485530546623755e-01 1.604144337263308240e-01 1.596998928188638756e-01 1.618435155412647486e-01 1.600571632725973636e-01 1.575562700964630303e-01 1.541622007859949905e-01 1.502322257949267603e-01 1.527331189710610937e-01 1.488031439799928635e-01 1.430868167202572483e-01 1.355841371918542204e-01
1.361200428724544387e-01 1.386209360485887720e-01 1.429081814933904904e-01 1.450518042157913634e-01 1.521972132904608754e-01 1.509467667023937087e-01 1.493390496605930817e-01 1.484458735262593754e-01 1.577349053233297604e-01 1.584494462307967089e-01 1.598785280457306057e-01 1.618435155412647486e-01 1.643444087173990820e-01 1.618435155412647486e-01 1.591639871382636573e-01 1.591639871382636573e-01 1.554126473740621572e-01 1.520185780635941453e-01 1.505894962486602484e-01 1.432654519471239785e-01 1.398713826366559387e-01
1.337977849231868632e-01 1.354055019649874902e-01 1.421936405859235419e-01 1.475526973919256968e-01 1.527331189710610937e-01 1.543408360128617485e-01 1.541622007859949905e-01 1.511254019292604389e-01 1.545194712397284786e-01 1.586280814576634390e-01 1.636298678099321058e-01 1.664880314397999272e-01 1.650589496248660304e-01 1.618435155412647486e-01 1.611289746337977724e-01 1.593426223651304152e-01 1.555912826009289152e-01 1.546981064665952088e-01 1.491604144337263238e-01 1.450518042157913634e-01 1.377277599142550935e-01
1.334405144694533751e-01 1.382636655948553117e-01 1.448731689889246055e-01 1.495176848874598119e-01 1.536262951053947723e-01 1.548767416934619390e-01 1.534476598785280421e-01 1.520185780635941453e-01 1.568417291889960818e-01 1.595212575919971454e-01 1.639871382636655939e-01 1.663093962129331971e-01 1.661307609860664392e-01 1.630939621293319153e-01 1.613076098606645303e-01 1.623794212218649391e-01 1.571989996427295422e-01 1.577349053233297604e-01 1.518399428367274151e-01 1.491604144337263238e-01 1.398713826366559387e-01
1.339764201500535934e-01 1.377277599142550935e-01 1.452304394426580936e-01 1.480886030725259150e-01 1.529117541979278239e-01 1.555912826009289152e-01 1.554126473740621572e-01 1.564844587352625938e-01 1.600571632725973636e-01 1.620221507681314788e-01 1.652375848517327606e-01 1.654162200785994907e-01 1.695248302965344789e-01 1.639871382636655939e-01 1.604144337263308240e-01 1.614862450875312605e-01 1.593426223651304152e-01 1.561271882815291057e-01 1.521972132904608754e-01 1.464808860307252603e-01 1.386209360485887720e-01
1.337977849231868632e-01 1.416577349053233237e-01 1.479099678456591571e-01 1.507681314755269786e-01 1.541622007859949905e-01 1.555912826009289152e-01 1.586280814576634390e-01 1.586280814576634390e-01 1.648803143979992725e-01 1.632725973561986454e-01 1.643444087173990820e-01 1.639871382636655939e-01 1.652375848517327606e-01 1.630939621293319153e-01 1.622007859949982089e-01 1.605930689531975819e-01 1.546981064665952088e-01 1.554126473740621572e-01 1.484458735262593754e-01 1.448731689889246055e-01 1.341550553769203236e-01
1.371918542336548752e-01 1.429081814933904904e-01 1.477313326187924269e-01 1.532690246516613120e-01 1.563058235083958636e-01 1.557699178277956453e-01 1.586280814576634390e-01 1.591639871382636573e-01 1.641657734905323240e-01 1.630939621293319153e-01 1.647016791711325423e-01 1.645230439442658121e-01 1.647016791711325423e-01 1.636298678099321058e-01 1.602357984994640938e-01 1.564844587352625938e-01 1.520185780635941453e-01 1.509467667023937087e-01 1.441586280814576571e-01 1.362986780993211966e-01 1.280814576634512203e-01
1.371918542336548752e-01 1.421936405859235419e-01 1.488031439799928635e-01 1.530903894247945818e-01 1.563058235083958636e-01 1.550553769203286969e-01 1.580921757770632485e-01 1.577349053233297604e-01 1.623794212218649391e-01 1.584494462307967089e-01 1.613076098606645303e-01 1.616648803143979907e-01 1.650589496248660304e-01 1.618435155412647486e-01 1.568417291889960818e-01 1.521972132904608754e-01 1.495176848874598119e-01 1.438013576277241967e-01 1.377277599142550935e-01 1.325473383351196965e-01 1.234369417649160416e-01
1.359414076455877085e-01 1.396927474097892086e-01 1.429081814933904904e-01 1.500535905680600302e-01 1.543408360128617485e-01 1.561271882815291057e-01 1.568417291889960818e-01 1.570203644158628120e-01 1.571989996427295422e-01 1.577349053233297604e-01 1.616648803143979907e-01 1.613076098606645303e-01 1.616648803143979907e-01 1.600571632725973636e-01 1.550553769203286969e-01 1.470167917113254785e-01 1.418363701321900816e-01 1.400500178635226967e-01 1.318327974276527204e-01 1.218292247231154007e-01 1.136120042872454383e-01
1.345123258306538117e-01 1.355841371918542204e-01 1.413004644515898633e-01 1.443372633083244150e-01 1.477313326187924269e-01 1.523758485173276056e-01 1.525544837441943635e-01 1.530903894247945818e-01 1.539835655591282604e-01 1.521972132904608754e-01 1.584494462307967089e-01 1.584494462307967089e-01 1.554126473740621572e-01 1.546981064665952088e-01 1.486245087531261055e-01 1.413004644515898633e-01 1.350482315112540299e-01 1.305823508395855537e-01 1.221864951768488750e-01 1.098606645230439383e-01 1.045016077170417973e-01
1.314755269739192600e-01 1.339764201500535934e-01 1.364773133261879268e-01 1.396927474097892086e-01 1.446945337620578753e-01 1.491604144337263238e-01 1.500535905680600302e-01 1.502322257949267603e-01 1.509467667023937087e-01 1.493390496605930817e-01 1.536262951053947723e-01 1.516613076098606572e-01 1.516613076098606572e-01 1.498749553411932722e-01 1.405859235441228872e-01 1.345123258306538117e-01 1.264737406216505933e-01 1.209360485887817083e-01 1.103965702036441565e-01 1.018220793140407338e-01 9.628438728117184875e-02
1.255805644873168869e-01 1.262951053947838631e-01 1.295105394783851449e-01 1.375491246873883633e-01 1.396927474097892086e-01 1.427295462665237602e-01 1.455877098963915817e-01 1.452304394426580936e-01 1.464808860307252603e-01 1.414790996784565935e-01 1.434440871739907086e-01 1.441586280814576571e-01 1.457663451232583118e-01 1.395141121829224784e-01 1.327259735619864267e-01 1.279028224365844901e-01 1.209360485887817083e-01 1.132547338335119641e-01 1.027152554483744262e-01 9.521257591997141223e-02 8.824580207216863037e-02
1.164701679171132598e-01 1.232583065380492976e-01 1.264737406216505933e-01 1.284387281171847084e-01 1.334405144694533751e-01 1.386209360485887720e-01 1.391568417291889903e-01 1.427295462665237602e-01 1.380850303679885538e-01 1.330832440157198870e-01 1.375491246873883633e-01 1.368345837799213871e-01 1.330832440157198870e-01 1.330832440157198870e-01 1.279028224365844901e-01 1.211146838156484523e-01 1.128974633797784899e-01 1.084315827081100414e-01 9.789210432297248965e-02 9.074669524830296374e-02 8.199356913183279694e-02
1.084315827081100414e-01 1.150410861021793490e-01 1.189710610932475932e-01 1.220078599499821309e-01 1.271882815291175417e-01 1.312968917470525299e-01 1.323687031082529386e-01 1.327259735619864267e-01 1.284387281171847084e-01 1.246873883529832083e-01 1.300464451589853632e-01 1.261164701679171052e-01 1.289746337977849266e-01 1.259378349410503750e-01 1.202215076813147598e-01 1.143265451947124006e-01 1.077170418006430930e-01 9.771346909610574560e-02 9.038942479456948953e-02 8.413719185423365610e-02 7.591997141836370755e-02
