1.108725849223386739e-01 1.130193206212905671e-01 1.128930420507639892e-01 1.121353706276044943e-01 1.091046849349665421e-01 1.069579492360146489e-01 1.060739992423285760e-01 1.088521277939133725e-01 1.118828134865513385e-01 1.130193206212905671e-01 1.165551205960348585e-01 1.217325419876247039e-01 1.226164919813107768e-01 1.250157848213158118e-01 1.282990276550069475e-01 1.312034347771183218e-01 1.347392347518626132e-01 1.363808561687081811e-01 1.365071347392347589e-01 1.347392347518626132e-01 1.309508776360651661e-01
1.116302563454981689e-01 1.145346634676095432e-01 1.156711706023487857e-01 1.141558277560297957e-01 1.117565349160247468e-01 1.096097992170728674e-01 1.089784063644399503e-01 1.092309635054931199e-01 1.107463063518120960e-01 1.140295491855032178e-01 1.192069705770930632e-01 1.240055562571031750e-01 1.245106705392095003e-01 1.269099633792145354e-01 1.312034347771183218e-01 1.344866776108094575e-01 1.360020204571284197e-01 1.391589847202929775e-01 1.378961990150271433e-01 1.371385275918676483e-01 1.319611062002778168e-01
1.102411920697057707e-01 1.150397777497158686e-01 1.174390705897209175e-01 1.156711706023487857e-01 1.130193206212905671e-01 1.097360777875994453e-01 1.126404849097108196e-01 1.128930420507639892e-01 1.154186134612956161e-01 1.170602348781411839e-01 1.213537062760449564e-01 1.253946205328955732e-01 1.270362419497411410e-01 1.299406490718525153e-01 1.338552847581765404e-01 1.353706276044955303e-01 1.377699204445005654e-01 1.377699204445005654e-01 1.372648061623942539e-01 1.385275918676600604e-01 1.341078418992296961e-01
1.084732920823336250e-01 1.136507134739234703e-01 1.174390705897209175e-01 1.141558277560297957e-01 1.125142063391842417e-01 1.126404849097108196e-01 1.135244349033968925e-01 1.136507134739234703e-01 1.164288420255082668e-01 1.188281348655133157e-01 1.217325419876247039e-01 1.262785705265816460e-01 1.295618133602727540e-01 1.318348276297512389e-01 1.317085490592246610e-01 1.352443490339689247e-01 1.373910847329208318e-01 1.400429347139790504e-01 1.377699204445005654e-01 1.380224775855537211e-01 1.349917918929157690e-01
1.102411920697057707e-01 1.150397777497158686e-01 1.168076777370880143e-01 1.157974491728753635e-01 1.120090920570779164e-01 1.128930420507639892e-01 1.146609420381361349e-01 1.140295491855032178e-01 1.165551205960348585e-01 1.198383634297259803e-01 1.232478848339436800e-01 1.277939133729006083e-01 1.286778633665866811e-01 1.338552847581765404e-01 1.333501704760702011e-01 1.361282990276549976e-01 1.378961990150271433e-01 1.396640990023992890e-01 1.391589847202929775e-01 1.380224775855537211e-01 1.343603990402828519e-01
1.063265563833817456e-01 1.111251420633918435e-01 1.151660563202424603e-01 1.135244349033968925e-01 1.121353706276044943e-01 1.144083848970829653e-01 1.142821063265563875e-01 1.155448920318221939e-01 1.194595277181462328e-01 1.197120848591993886e-01 1.241318348276297528e-01 1.281727490844803696e-01 1.298143705013259375e-01 1.329713347644904675e-01 1.341078418992296961e-01 1.356231847455486861e-01 1.368859704508144925e-01 1.399166561434524447e-01 1.406743275666119397e-01 1.395378204318727111e-01 1.337290061876499625e-01
1.064528349539083235e-01 1.097360777875994453e-01 1.159237277434019414e-01 1.137769920444500621e-01 1.141558277560297957e-01 1.136507134739234703e-01 1.140295491855032178e-01 1.160500063139285332e-01 1.214799848465715343e-01 1.229953276928905104e-01 1.267836848086879575e-01 1.293092562192195982e-01 1.286778633665866811e-01 1.314559919181714776e-01 1.341078418992296961e-01 1.344866776108094575e-01 1.361282990276549976e-01 1.376436418739739875e-01 1.404217704255587840e-01 1.387801490087132161e-01 1.323399419118575504e-01
1.072105063770678185e-01 1.101149134991791928e-01 1.165551205960348585e-01 1.179441848718272567e-01 1.160500063139285332e-01 1.161762848844551110e-01 1.170602348781411839e-01 1.169339563076145921e-01 1.219850991286778596e-01 1.240055562571031750e-01 1.284253062255335254e-01 1.289304205076398646e-01 1.296880919307993318e-01 1.315822704886980554e-01 1.329713347644904675e-01 1.329713347644904675e-01 1.352443490339689247e-01 1.381487561560803268e-01 1.371385275918676483e-01 1.362545775981815754e-01 1.294355347897461761e-01
1.098623563581260232e-01 1.163025634549816889e-01 1.213537062760449564e-01 1.223639348402576071e-01 1.199646420002525582e-01 1.207223134234120532e-01 1.200909205707791361e-01 1.224902134107841850e-01 1.253946205328955732e-01 1.270362419497411410e-01 1.291829776486930204e-01 1.313297133476448997e-01 1.300669276423790932e-01 1.305720419244854047e-01 1.329713347644904675e-01 1.347392347518626132e-01 1.372648061623942539e-01 1.363808561687081811e-01 1.351180704634423468e-01 1.333501704760702011e-01 1.285515847960601032e-01
1.133981563328703146e-01 1.170602348781411839e-01 1.222376562697310293e-01 1.233741634044702579e-01 1.240055562571031750e-01 1.217325419876247039e-01 1.246369491097360782e-01 1.252683419623689953e-01 1.284253062255335254e-01 1.270362419497411410e-01 1.308245990655385882e-01 1.322136633413309725e-01 1.312034347771183218e-01 1.313297133476448997e-01 1.344866776108094575e-01 1.366334133097613368e-01 1.377699204445005654e-01 1.361282990276549976e-01 1.372648061623942539e-01 1.338552847581765404e-01 1.285515847960601032e-01
1.131455991918171450e-01 1.197120848591993886e-01 1.257734562444753068e-01 1.269099633792145354e-01 1.277939133729006083e-01 1.289304205076398646e-01 1.277939133729006083e-01 1.279201919434272139e-01 1.306983204950120103e-01 1.300669276423790932e-01 1.339815633287031182e-01 1.342341204697562740e-01 1.342341204697562740e-01 1.343603990402828519e-01 1.366334133097613368e-01 1.363808561687081811e-01 1.357494633160752640e-01 1.367596918802879147e-01 1.342341204697562740e-01 1.322136633413309725e-01 1.245106705392095003e-01
1.161762848844551110e-01 1.204697562823588836e-01 1.272887990907942968e-01 1.281727490844803696e-01 1.282990276550069475e-01 1.286778633665866811e-01 1.279201919434272139e-01 1.277939133729006083e-01 1.296880919307993318e-01 1.304457633539588268e-01 1.318348276297512389e-01 1.319611062002778168e-01 1.329713347644904675e-01 1.336027276171233846e-01 1.344866776108094575e-01 1.346129561813360354e-01 1.342341204697562740e-01 1.358757418866018418e-01 1.330976133350170454e-01 1.285515847960601032e-01 1.199646420002525582e-01
1.166813991665614364e-01 1.238792776865765832e-01 1.291829776486930204e-01 1.304457633539588268e-01 1.299406490718525153e-01 1.300669276423790932e-01 1.301932062129056711e-01 1.282990276550069475e-01 1.295618133602727540e-01 1.313297133476448997e-01 1.305720419244854047e-01 1.319611062002778168e-01 1.314559919181714776e-01 1.324662204823841283e-01 1.324662204823841283e-01 1.298143705013259375e-01 1.322136633413309725e-01 1.317085490592246610e-01 1.301932062129056711e-01 1.247632276802626561e-01 1.169339563076145921e-01
1.211011491349917868e-01 1.265311276676348018e-01 1.289304205076398646e-01 1.315822704886980554e-01 1.313297133476448997e-01 1.304457633539588268e-01 1.281727490844803696e-01 1.264048490971082239e-01 1.282990276550069475e-01 1.288041419371132590e-01 1.310771562065917439e-01 1.310771562065917439e-01 1.299406490718525153e-01 1.309508776360651661e-01 1.293092562192195982e-01 1.271625205202677189e-01 1.275413562318474525e-01 1.296880919307993318e-01 1.272887990907942968e-01 1.221113776992044514e-01 1.140295491855032178e-01
1.245106705392095003e-01 1.279201919434272139e-01 1.305720419244854047e-01 1.341078418992296961e-01 1.327187776234373118e-01 1.330976133350170454e-01 1.286778633665866811e-01 1.304457633539588268e-01 1.325924990529107339e-01 1.310771562065917439e-01 1.317085490592246610e-01 1.327187776234373118e-01 1.322136633413309725e-01 1.319611062002778168e-01 1.299406490718525153e-01 1.264048490971082239e-01 1.262785705265816460e-01 1.265311276676348018e-01 1.233741634044702579e-01 1.194595277181462328e-01 1.127667634802373975e-01
1.265311276676348018e-01 1.300669276423790932e-01 1.349917918929157690e-01 1.353706276044955303e-01 1.362545775981815754e-01 1.360020204571284197e-01 1.352443490339689247e-01 1.363808561687081811e-01 1.384013132971334825e-01 1.354969061750221082e-01 1.366334133097613368e-01 1.362545775981815754e-01 1.334764490465967790e-01 1.310771562065917439e-01 1.286778633665866811e-01 1.296880919307993318e-01 1.280464705139537918e-01 1.245106705392095003e-01 1.226164919813107768e-01 1.195858062886728107e-01 1.122616491981310721e-01
1.293092562192195982e-01 1.333501704760702011e-01 1.396640990023992890e-01 1.373910847329208318e-01 1.381487561560803268e-01 1.384013132971334825e-01 1.385275918676600604e-01 1.385275918676600604e-01 1.376436418739739875e-01 1.356231847455486861e-01 1.375173633034474097e-01 1.361282990276549976e-01 1.354969061750221082e-01 1.348655133223891911e-01 1.291829776486930204e-01 1.300669276423790932e-01 1.284253062255335254e-01 1.231216062634171021e-01 1.235004419749968496e-01 1.179441848718272567e-01 1.099886349286526011e-01
1.328450561939638896e-01 1.363808561687081811e-01 1.401692132845056282e-01 1.405480489960853618e-01 1.402954918550322061e-01 1.406743275666119397e-01 1.391589847202929775e-01 1.392852632908195554e-01 1.365071347392347589e-01 1.372648061623942539e-01 1.390327061497663719e-01 1.357494633160752640e-01 1.334764490465967790e-01 1.324662204823841283e-01 1.295618133602727540e-01 1.282990276550069475e-01 1.281727490844803696e-01 1.237529991160500054e-01 1.202171991413057139e-01 1.169339563076145921e-01 1.094835206465462757e-01
1.338552847581765404e-01 1.362545775981815754e-01 1.386538704381866383e-01 1.397903775729258669e-01 1.394115418613461332e-01 1.386538704381866383e-01 1.380224775855537211e-01 1.396640990023992890e-01 1.358757418866018418e-01 1.362545775981815754e-01 1.378961990150271433e-01 1.356231847455486861e-01 1.314559919181714776e-01 1.293092562192195982e-01 1.274150776613208746e-01 1.269099633792145354e-01 1.243843919686829086e-01 1.217325419876247039e-01 1.183230205834069904e-01 1.123879277686576639e-01 1.039272635433766828e-01
1.360020204571284197e-01 1.358757418866018418e-01 1.389064275792397940e-01 1.381487561560803268e-01 1.387801490087132161e-01 1.362545775981815754e-01 1.363808561687081811e-01 1.351180704634423468e-01 1.342341204697562740e-01 1.325924990529107339e-01 1.305720419244854047e-01 1.298143705013259375e-01 1.262785705265816460e-01 1.243843919686829086e-01 1.223639348402576071e-01 1.240055562571031750e-01 1.199646420002525582e-01 1.169339563076145921e-01 1.139032706149766400e-01 1.087258492233867946e-01 1.010228564212653085e-01
1.330976133350170454e-01 1.352443490339689247e-01 1.366334133097613368e-01 1.341078418992296961e-01 1.336027276171233846e-01 1.315822704886980554e-01 1.329713347644904675e-01 1.317085490592246610e-01 1.275413562318474525e-01 1.251420633918424175e-01 1.240055562571031750e-01 1.213537062760449564e-01 1.187018562949867378e-01 1.168076777370880143e-01 1.140295491855032178e-01 1.142821063265563875e-01 1.109988634928652657e-01 1.108725849223386739e-01 1.080944563707538775e-01 1.053163278191690810e-01 9.912867786336658493e-02
