1.100383547149847846e-01 1.105673852664991463e-01 1.096415818013490306e-01 1.084512630604417410e-01 1.064673984922629296e-01 1.040867610104483504e-01 1.018383811665123651e-01 1.003835471498479015e-01 1.014416082528765972e-01 1.026319269937838868e-01 1.072609443195344514e-01 1.124189921967993638e-01 1.155931755058854649e-01 1.223383150376934209e-01 1.257770136225367097e-01 1.301415156725301003e-01 1.282899087422298690e-01 1.281576511043512889e-01 1.276286205528369133e-01 1.249834677952651740e-01 1.226028303134506087e-01
1.128157651104351317e-01 1.137415685755852335e-01 1.138738262134638274e-01 1.118899616452850160e-01 1.105673852664991463e-01 1.069964290437772775e-01 1.030286999074196547e-01 1.042190186483269443e-01 1.058061103028699879e-01 1.093770665255918567e-01 1.136093109377066535e-01 1.177092977119428702e-01 1.202221928316360294e-01 1.253802407089009419e-01 1.305382885861658404e-01 1.331834413437376075e-01 1.329189260679804196e-01 1.305382885861658404e-01 1.289511969316227968e-01 1.273641052770797533e-01 1.256447559846581019e-01
1.103028699907419585e-01 1.141383414892210013e-01 1.162544636952784066e-01 1.140060838513424213e-01 1.121544769210421899e-01 1.104351276286205524e-01 1.091125512498346828e-01 1.088480359740775089e-01 1.129480227483137117e-01 1.154609178680068710e-01 1.178415553498214502e-01 1.241899219679936522e-01 1.249834677952651740e-01 1.284221663801084490e-01 1.319931226028303040e-01 1.345060177225234632e-01 1.327866684301018396e-01 1.323898955164660718e-01 1.300092580346514926e-01 1.277608781907155211e-01 1.269673323634439854e-01
1.077899748710487993e-01 1.155931755058854649e-01 1.153286602301282909e-01 1.144028567649781752e-01 1.134770532998280596e-01 1.122867345589207838e-01 1.105673852664991463e-01 1.124189921967993638e-01 1.169157518846713345e-01 1.194286470043645076e-01 1.210157386589075512e-01 1.249834677952651740e-01 1.261737865361724775e-01 1.308028038619230282e-01 1.315963496891945639e-01 1.342415024467663032e-01 1.343737600846448832e-01 1.311995767755587960e-01 1.300092580346514926e-01 1.272318476392011732e-01 1.256447559846581019e-01
1.046157915619626982e-01 1.108319005422563203e-01 1.128157651104351317e-01 1.138738262134638274e-01 1.144028567649781752e-01 1.149318873164925231e-01 1.144028567649781752e-01 1.173125247983071023e-01 1.182383282634572180e-01 1.220737997619362469e-01 1.231318608649649565e-01 1.255124983467795219e-01 1.268350747255654054e-01 1.297447427588943325e-01 1.333156989816161875e-01 1.329189260679804196e-01 1.334479566194947675e-01 1.322576378785874918e-01 1.297447427588943325e-01 1.288189392937442168e-01 1.270995900013225655e-01
1.026319269937838868e-01 1.054093373892342339e-01 1.112286734558920742e-01 1.128157651104351317e-01 1.138738262134638274e-01 1.166512366089141606e-01 1.174447824361856962e-01 1.179738129877000441e-01 1.170480095225499284e-01 1.240576643301150583e-01 1.239254066922364783e-01 1.274963629149583333e-01 1.273641052770797533e-01 1.289511969316227968e-01 1.335802142573733753e-01 1.362253670149451146e-01 1.329189260679804196e-01 1.334479566194947675e-01 1.314640920513159561e-01 1.284221663801084490e-01 1.257770136225367097e-01
1.003835471498479015e-01 1.046157915619626982e-01 1.110964158180134942e-01 1.128157651104351317e-01 1.138738262134638274e-01 1.163867213331569866e-01 1.178415553498214502e-01 1.170480095225499284e-01 1.188996164528501459e-01 1.235286337786007105e-01 1.257770136225367097e-01 1.263060441740510575e-01 1.274963629149583333e-01 1.294802274831371447e-01 1.325221531543446518e-01 1.325221531543446518e-01 1.323898955164660718e-01 1.306705462240444482e-01 1.306705462240444482e-01 1.270995900013225655e-01 1.232641185028435366e-01
9.734162147864039438e-02 1.054093373892342339e-01 1.114931887316492481e-01 1.163867213331569866e-01 1.163867213331569866e-01 1.188996164528501459e-01 1.175770400740642763e-01 1.203544504695146095e-01 1.220737997619362469e-01 1.248512101573865940e-01 1.257770136225367097e-01 1.276286205528369133e-01 1.281576511043512889e-01 1.281576511043512889e-01 1.305382885861658404e-01 1.305382885861658404e-01 1.314640920513159561e-01 1.315963496891945639e-01 1.294802274831371447e-01 1.251157254331437541e-01 1.187673588149715659e-01
1.022351540801481329e-01 1.096415818013490306e-01 1.146673720407353492e-01 1.182383282634572180e-01 1.174447824361856962e-01 1.206189657452717834e-01 1.216770268483004930e-01 1.233963761407221305e-01 1.253802407089009419e-01 1.257770136225367097e-01 1.251157254331437541e-01 1.259092712604152897e-01 1.269673323634439854e-01 1.282899087422298690e-01 1.298770003967729125e-01 1.302737733104086804e-01 1.326544107922232596e-01 1.305382885861658404e-01 1.248512101573865940e-01 1.216770268483004930e-01 1.149318873164925231e-01
1.030286999074196547e-01 1.095093241634704367e-01 1.174447824361856962e-01 1.194286470043645076e-01 1.208834810210289712e-01 1.256447559846581019e-01 1.244544372437508262e-01 1.245866948816294201e-01 1.244544372437508262e-01 1.272318476392011732e-01 1.274963629149583333e-01 1.265705594498082176e-01 1.290834545695013769e-01 1.301415156725301003e-01 1.306705462240444482e-01 1.298770003967729125e-01 1.302737733104086804e-01 1.272318476392011732e-01 1.253802407089009419e-01 1.194286470043645076e-01 1.114931887316492481e-01
1.083190054225631471e-01 1.128157651104351317e-01 1.202221928316360294e-01 1.229996032270863626e-01 1.261737865361724775e-01 1.256447559846581019e-01 1.284221663801084490e-01 1.263060441740510575e-01 1.241899219679936522e-01 1.277608781907155211e-01 1.274963629149583333e-01 1.290834545695013769e-01 1.278931358285941011e-01 1.264383018119296376e-01 1.288189392937442168e-01 1.288189392937442168e-01 1.273641052770797533e-01 1.247189525195080001e-01 1.179738129877000441e-01 1.147996296786139431e-01 1.100383547149847846e-01
1.109641581801349003e-01 1.166512366089141606e-01 1.218092844861790730e-01 1.270995900013225655e-01 1.280253934664726811e-01 1.282899087422298690e-01 1.277608781907155211e-01 1.285544240179870290e-01 1.261737865361724775e-01 1.276286205528369133e-01 1.289511969316227968e-01 1.288189392937442168e-01 1.255124983467795219e-01 1.264383018119296376e-01 1.251157254331437541e-01 1.280253934664726811e-01 1.245866948816294201e-01 1.220737997619362469e-01 1.179738129877000441e-01 1.108319005422563203e-01 1.031609575452982347e-01
1.190318740907287398e-01 1.237931490543578844e-01 1.282899087422298690e-01 1.325221531543446518e-01 1.321253802407089117e-01 1.306705462240444482e-01 1.310673191376801883e-01 1.281576511043512889e-01 1.273641052770797533e-01 1.267028170876868254e-01 1.263060441740510575e-01 1.274963629149583333e-01 1.263060441740510575e-01 1.243221796058722323e-01 1.229996032270863626e-01 1.218092844861790730e-01 1.244544372437508262e-01 1.183705859013357981e-01 1.133447956619494795e-01 1.079222325089273932e-01 1.009125777013622494e-01
1.236608914164793044e-01 1.301415156725301003e-01 1.349027906361592311e-01 1.356963364634307667e-01 1.350350482740378388e-01 1.330511837058589997e-01 1.308028038619230282e-01 1.300092580346514926e-01 1.286866816558656368e-01 1.282899087422298690e-01 1.285544240179870290e-01 1.272318476392011732e-01 1.257770136225367097e-01 1.236608914164793044e-01 1.235286337786007105e-01 1.228673455892077826e-01 1.190318740907287398e-01 1.154609178680068710e-01 1.117577040074064221e-01 1.058061103028699879e-01 9.892871313318343796e-02
1.260415288982938697e-01 1.310673191376801883e-01 1.393995503240312017e-01 1.397963232376669696e-01 1.366221399285808824e-01 1.363576246528236946e-01 1.362253670149451146e-01 1.354318211876735789e-01 1.331834413437376075e-01 1.277608781907155211e-01 1.285544240179870290e-01 1.278931358285941011e-01 1.224705726755720148e-01 1.247189525195080001e-01 1.253802407089009419e-01 1.212802539346647251e-01 1.183705859013357981e-01 1.155931755058854649e-01 1.093770665255918567e-01 1.034254728210554225e-01 9.919322840894061188e-02
1.297447427588943325e-01 1.325221531543446518e-01 1.395318079619098095e-01 1.395318079619098095e-01 1.392672926861526217e-01 1.388705197725168539e-01 1.374156857558523903e-01 1.359608517391879268e-01 1.329189260679804196e-01 1.301415156725301003e-01 1.288189392937442168e-01 1.265705594498082176e-01 1.256447559846581019e-01 1.241899219679936522e-01 1.223383150376934209e-01 1.200899351937574355e-01 1.174447824361856962e-01 1.106996429043777264e-01 1.087157783361989150e-01 1.022351540801481329e-01 9.509324163470440905e-02
1.317286073270731439e-01 1.349027906361592311e-01 1.388705197725168539e-01 1.409866419785742730e-01 1.392672926861526217e-01 1.395318079619098095e-01 1.368866552043380425e-01 1.350350482740378388e-01 1.313318344134373761e-01 1.276286205528369133e-01 1.281576511043512889e-01 1.236608914164793044e-01 1.226028303134506087e-01 1.222060573998148408e-01 1.207512233831503773e-01 1.170480095225499284e-01 1.170480095225499284e-01 1.132125380240708856e-01 1.095093241634704367e-01 9.998677423621214755e-02 9.549001454834016300e-02
1.321253802407089117e-01 1.345060177225234632e-01 1.375479433937309981e-01 1.384737468588811138e-01 1.368866552043380425e-01 1.368866552043380425e-01 1.360931093770665345e-01 1.337124718952519553e-01 1.285544240179870290e-01 1.251157254331437541e-01 1.214125115725433190e-01 1.218092844861790730e-01 1.175770400740642763e-01 1.182383282634572180e-01 1.196931622801216816e-01 1.179738129877000441e-01 1.142705991270995952e-01 1.117577040074064221e-01 1.051448221134770600e-01 9.839968258166909010e-02 9.191905832561830803e-02
1.297447427588943325e-01 1.347705329982806510e-01 1.359608517391879268e-01 1.360931093770665345e-01 1.354318211876735789e-01 1.355640788255521867e-01 1.339769871710091154e-01 1.306705462240444482e-01 1.284221663801084490e-01 1.226028303134506087e-01 1.206189657452717834e-01 1.171802671604285084e-01 1.155931755058854649e-01 1.161222060573998127e-01 1.178415553498214502e-01 1.153286602301282909e-01 1.110964158180134942e-01 1.079222325089273932e-01 1.019706388043909590e-01 9.601904509985451086e-02 9.165454304986113410e-02
1.249834677952651740e-01 1.335802142573733753e-01 1.334479566194947675e-01 1.352995635497949989e-01 1.322576378785874918e-01 1.341092448088877231e-01 1.305382885861658404e-01 1.276286205528369133e-01 1.224705726755720148e-01 1.194286470043645076e-01 1.142705991270995952e-01 1.117577040074064221e-01 1.092448088877132628e-01 1.113609310937706681e-01 1.104351276286205524e-01 1.081867477846845671e-01 1.075254595952916253e-01 1.028964422695410608e-01 9.985451659833355365e-02 9.469646872106864122e-02 9.046422430895384448e-02
1.252479830710223618e-01 1.300092580346514926e-01 1.335802142573733753e-01 1.339769871710091154e-01 1.331834413437376075e-01 1.304060309482872604e-01 1.260415288982938697e-01 1.249834677952651740e-01 1.200899351937574355e-01 1.162544636952784066e-01 1.112286734558920742e-01 1.073932019574130453e-01 1.039545033725697704e-01 1.075254595952916253e-01 1.063351408543843357e-01 1.048803068377198722e-01 1.043512762862055243e-01 9.879645549530485793e-02 9.681259092712604652e-02 9.244808887713265588e-02 8.967067848168232269e-02
