1.155583437892095389e-01 1.169385194479297396e-01 1.186951066499372653e-01 1.146800501882057760e-01 1.125470514429109115e-01 1.102885821831869478e-01 1.099121706398996229e-01 1.106649937264742728e-01 1.120451693851944736e-01 1.154328732747804259e-01 1.209535759096612290e-01 1.213299874529485539e-01 1.253450439146800433e-01 1.314930991217063971e-01 1.363864491844416493e-01 1.388958594730238527e-01 1.395232120451693758e-01 1.391468005018820508e-01 1.387703889585947259e-01 1.337515683814303746e-01 1.299874529485570973e-01
1.184441656210790533e-01 1.203262233375156781e-01 1.225846925972396556e-01 1.200752823086574661e-01 1.169385194479297396e-01 1.122961104140526994e-01 1.134253450439146743e-01 1.153074027603513130e-01 1.183186951066499404e-01 1.194479297365119153e-01 1.238393977415307434e-01 1.254705144291091701e-01 1.335006273525721487e-01 1.367628607277289743e-01 1.392722710163111777e-01 1.427854454203262291e-01 1.422835633626097773e-01 1.427854454203262291e-01 1.411543287327478025e-01 1.395232120451693758e-01 1.338770388958594737e-01
1.185696361355081524e-01 1.214554579673776669e-01 1.203262233375156781e-01 1.198243412797992541e-01 1.184441656210790533e-01 1.159347553324968638e-01 1.171894604767879516e-01 1.183186951066499404e-01 1.194479297365119153e-01 1.219573400250941048e-01 1.287327478042659956e-01 1.309912170639899731e-01 1.347553324968632504e-01 1.409033877038895766e-01 1.414052697616060283e-01 1.431618569636135541e-01 1.431618569636135541e-01 1.422835633626097773e-01 1.434127979924717800e-01 1.405269761606022516e-01 1.362609786700125503e-01
1.185696361355081524e-01 1.213299874529485539e-01 1.214554579673776669e-01 1.199498117942283532e-01 1.180677540777917145e-01 1.153074027603513130e-01 1.170639899623588526e-01 1.196988707653701411e-01 1.204516938519447911e-01 1.258469259723964950e-01 1.267252195734002440e-01 1.317440401505646230e-01 1.366373902132998752e-01 1.400250941028858276e-01 1.435382685069008790e-01 1.425345043914680032e-01 1.446675031367628539e-01 1.434127979924717800e-01 1.442910915934755289e-01 1.388958594730238527e-01 1.346298619824341236e-01
1.150564617314931010e-01 1.183186951066499404e-01 1.194479297365119153e-01 1.178168130489335025e-01 1.180677540777917145e-01 1.179422835633626154e-01 1.191969887076537032e-01 1.208281053952321160e-01 1.243412797992471813e-01 1.258469259723964950e-01 1.304893350062735213e-01 1.301129234629861964e-01 1.376411543287327510e-01 1.405269761606022516e-01 1.425345043914680032e-01 1.434127979924717800e-01 1.425345043914680032e-01 1.455457967377666306e-01 1.437892095357591049e-01 1.387703889585947259e-01 1.343789209535758977e-01
1.102885821831869478e-01 1.158092848180677509e-01 1.179422835633626154e-01 1.200752823086574661e-01 1.175658720200752766e-01 1.199498117942283532e-01 1.209535759096612290e-01 1.202007528230865790e-01 1.224592220828105427e-01 1.299874529485570973e-01 1.316185696361354962e-01 1.342534504391467987e-01 1.368883312421581011e-01 1.402760351317440535e-01 1.429109159347553282e-01 1.429109159347553282e-01 1.436637390213299781e-01 1.436637390213299781e-01 1.424090338770389041e-01 1.396486825595985026e-01 1.347553324968632504e-01
1.120451693851944736e-01 1.164366373902133017e-01 1.208281053952321160e-01 1.217063989962358789e-01 1.207026348808030169e-01 1.213299874529485539e-01 1.235884567126725175e-01 1.229611041405269806e-01 1.264742785445420459e-01 1.311166875784190722e-01 1.329987452948556970e-01 1.341279799247176996e-01 1.372647427854454261e-01 1.397741530740276017e-01 1.429109159347553282e-01 1.429109159347553282e-01 1.431618569636135541e-01 1.432873274780426531e-01 1.439146800501882040e-01 1.407779171894604775e-01 1.346298619824341236e-01
1.111668757841907107e-01 1.185696361355081524e-01 1.209535759096612290e-01 1.238393977415307434e-01 1.227101631116687547e-01 1.242158092848180684e-01 1.237139272271016305e-01 1.247176913425345063e-01 1.273525721455457949e-01 1.318695106649937221e-01 1.342534504391467987e-01 1.356336260978669994e-01 1.355081555834379003e-01 1.378920953575909769e-01 1.402760351317440535e-01 1.425345043914680032e-01 1.407779171894604775e-01 1.434127979924717800e-01 1.437892095357591049e-01 1.395232120451693758e-01 1.335006273525721487e-01
1.124215809284818124e-01 1.179422835633626154e-01 1.208281053952321160e-01 1.219573400250941048e-01 1.220828105395232177e-01 1.238393977415307434e-01 1.239648682559598564e-01 1.259723964868255941e-01 1.307402760351317472e-01 1.335006273525721487e-01 1.333751568381430497e-01 1.336260978670012478e-01 1.336260978670012478e-01 1.365119196988707762e-01 1.370138017565872002e-01 1.377666248431618501e-01 1.388958594730238527e-01 1.373902132998745251e-01 1.390213299874529518e-01 1.337515683814303746e-01 1.283563362609786707e-01
1.130489335006273494e-01 1.189460476787954774e-01 1.203262233375156781e-01 1.240903387703889554e-01 1.249686323713927183e-01 1.253450439146800433e-01 1.276035131744040207e-01 1.284818067754077697e-01 1.311166875784190722e-01 1.314930991217063971e-01 1.327478042659974988e-01 1.336260978670012478e-01 1.327478042659974988e-01 1.377666248431618501e-01 1.355081555834379003e-01 1.363864491844416493e-01 1.357590966122960985e-01 1.353826850690087735e-01 1.343789209535758977e-01 1.277289836888331198e-01 1.209535759096612290e-01
1.161856963613550758e-01 1.214554579673776669e-01 1.247176913425345063e-01 1.268506900878293708e-01 1.273525721455457949e-01 1.284818067754077697e-01 1.316185696361354962e-01 1.322459222082810470e-01 1.348808030112923495e-01 1.338770388958594737e-01 1.331242158092848238e-01 1.333751568381430497e-01 1.350062735257214486e-01 1.357590966122960985e-01 1.337515683814303746e-01 1.361355081555834512e-01 1.375156838143036520e-01 1.335006273525721487e-01 1.343789209535758977e-01 1.289836888331242215e-01 1.219573400250941048e-01
1.195734002509410282e-01 1.260978670012546932e-01 1.317440401505646230e-01 1.317440401505646230e-01 1.337515683814303746e-01 1.326223337515683720e-01 1.335006273525721487e-01 1.357590966122960985e-01 1.370138017565872002e-01 1.348808030112923495e-01 1.321204516938519480e-01 1.341279799247176996e-01 1.358845671267252253e-01 1.367628607277289743e-01 1.356336260978669994e-01 1.368883312421581011e-01 1.347553324968632504e-01 1.326223337515683720e-01 1.318695106649937221e-01 1.262233375156838200e-01 1.228356336260978676e-01
1.286072772898368965e-01 1.317440401505646230e-01 1.378920953575909769e-01 1.383939774153074009e-01 1.381430363864491750e-01 1.365119196988707762e-01 1.366373902132998752e-01 1.375156838143036520e-01 1.381430363864491750e-01 1.368883312421581011e-01 1.363864491844416493e-01 1.348808030112923495e-01 1.357590966122960985e-01 1.358845671267252253e-01 1.368883312421581011e-01 1.360100376411543244e-01 1.355081555834379003e-01 1.312421580928481712e-01 1.314930991217063971e-01 1.252195734002509442e-01 1.222082810539523168e-01
1.302383939774152954e-01 1.367628607277289743e-01 1.396486825595985026e-01 1.432873274780426531e-01 1.402760351317440535e-01 1.404015056461731525e-01 1.406524466750313784e-01 1.398996235884567008e-01 1.402760351317440535e-01 1.387703889585947259e-01 1.370138017565872002e-01 1.366373902132998752e-01 1.357590966122960985e-01 1.355081555834379003e-01 1.343789209535758977e-01 1.366373902132998752e-01 1.353826850690087735e-01 1.319949811794228489e-01 1.306148055207026482e-01 1.265997490589711449e-01 1.205771643663739040e-01
1.358845671267252253e-01 1.393977415307402767e-01 1.437892095357591049e-01 1.410288582183187034e-01 1.422835633626097773e-01 1.430363864491844550e-01 1.404015056461731525e-01 1.411543287327478025e-01 1.415307402760351274e-01 1.405269761606022516e-01 1.396486825595985026e-01 1.387703889585947259e-01 1.333751568381430497e-01 1.335006273525721487e-01 1.329987452948556970e-01 1.362609786700125503e-01 1.335006273525721487e-01 1.304893350062735213e-01 1.302383939774152954e-01 1.239648682559598564e-01 1.186951066499372653e-01
1.385194479297365000e-01 1.425345043914680032e-01 1.456712672521957297e-01 1.449184441656210798e-01 1.455457967377666306e-01 1.452948557089084047e-01 1.468005018820577046e-01 1.422835633626097773e-01 1.430363864491844550e-01 1.411543287327478025e-01 1.414052697616060283e-01 1.387703889585947259e-01 1.367628607277289743e-01 1.357590966122960985e-01 1.350062735257214486e-01 1.376411543287327510e-01 1.370138017565872002e-01 1.326223337515683720e-01 1.314930991217063971e-01 1.240903387703889554e-01 1.176913425345043895e-01
1.396486825595985026e-01 1.429109159347553282e-01 1.454203262233375038e-01 1.457967377666248565e-01 1.490589711417816821e-01 1.469259723964868314e-01 1.498117942283563320e-01 1.450439146800501788e-01 1.451693851944793057e-01 1.427854454203262291e-01 1.409033877038895766e-01 1.396486825595985026e-01 1.393977415307402767e-01 1.371392722710162992e-01 1.347553324968632504e-01 1.371392722710162992e-01 1.371392722710162992e-01 1.329987452948556970e-01 1.293601003764115465e-01 1.223337515683814297e-01 1.153074027603513130e-01
1.415307402760351274e-01 1.456712672521957297e-01 1.457967377666248565e-01 1.483061480552070321e-01 1.494353826850690070e-01 1.469259723964868314e-01 1.489335006273525830e-01 1.459222082810539556e-01 1.449184441656210798e-01 1.430363864491844550e-01 1.402760351317440535e-01 1.393977415307402767e-01 1.383939774153074009e-01 1.366373902132998752e-01 1.353826850690087735e-01 1.355081555834379003e-01 1.316185696361354962e-01 1.287327478042659956e-01 1.223337515683814297e-01 1.165621079046424147e-01 1.129234629861982503e-01
1.409033877038895766e-01 1.440401505646173030e-01 1.456712672521957297e-01 1.466750313676286055e-01 1.481806775407779053e-01 1.476787954830614813e-01 1.468005018820577046e-01 1.427854454203262291e-01 1.411543287327478025e-01 1.383939774153074009e-01 1.355081555834379003e-01 1.345043914680050245e-01 1.351317440401505754e-01 1.333751568381430497e-01 1.307402760351317472e-01 1.301129234629861964e-01 1.267252195734002440e-01 1.222082810539523168e-01 1.175658720200752766e-01 1.111668757841907107e-01 1.043914680050188198e-01
1.395232120451693758e-01 1.410288582183187034e-01 1.416562107904642542e-01 1.432873274780426531e-01 1.450439146800501788e-01 1.439146800501882040e-01 1.427854454203262291e-01 1.397741530740276017e-01 1.377666248431618501e-01 1.312421580928481712e-01 1.267252195734002440e-01 1.265997490589711449e-01 1.262233375156838200e-01 1.244667503136762804e-01 1.240903387703889554e-01 1.230865746549560796e-01 1.202007528230865790e-01 1.159347553324968638e-01 1.110414052697616116e-01 1.030112923462986191e-01 9.636135508155584117e-02
1.341279799247176996e-01 1.383939774153074009e-01 1.380175658720200760e-01 1.396486825595985026e-01 1.397741530740276017e-01 1.397741530740276017e-01 1.370138017565872002e-01 1.362609786700125503e-01 1.326223337515683720e-01 1.267252195734002440e-01 1.244667503136762804e-01 1.225846925972396556e-01 1.204516938519447911e-01 1.186951066499372653e-01 1.159347553324968638e-01 1.121706398996235865e-01 1.120451693851944736e-01 1.048933500627352577e-01 1.021329987452948562e-01 9.636135508155584117e-02 9.171894604767880099e-02
