1.297222222222222110e-01 1.322222222222222132e-01 1.301388888888888873e-01 1.256944444444444420e-01 1.198611111111111127e-01 1.140277777777777835e-01 1.119444444444444436e-01 1.129166666666666652e-01 1.116666666666666641e-01 1.155555555555555503e-01 1.183333333333333320e-01 1.194444444444444503e-01 1.243055555555555580e-01 1.237499999999999989e-01 1.250000000000000000e-01 1.263888888888888840e-01 1.245833333333333376e-01 1.230555555555555569e-01 1.197222222222222160e-01 1.172222222222222276e-01 1.156944444444444470e-01
1.309722222222222121e-01 1.309722222222222121e-01 1.283333333333333270e-01 1.233333333333333365e-01 1.193055555555555536e-01 1.163888888888888890e-01 1.136111111111111072e-01 1.143055555555555491e-01 1.163888888888888890e-01 1.186111111111111116e-01 1.230555555555555569e-01 1.224999999999999978e-01 1.263888888888888840e-01 1.275000000000000022e-01 1.256944444444444420e-01 1.286111111111111205e-01 1.247222222222222204e-01 1.247222222222222204e-01 1.202777777777777751e-01 1.176388888888888901e-01 1.163888888888888890e-01
1.305555555555555636e-01 1.309722222222222121e-01 1.263888888888888840e-01 1.248611111111111172e-01 1.213888888888888934e-01 1.176388888888888901e-01 1.187499999999999944e-01 1.170833333333333309e-01 1.205555555555555547e-01 1.226388888888888945e-01 1.243055555555555580e-01 1.277777777777777679e-01 1.266666666666666774e-01 1.295833333333333282e-01 1.304166666666666530e-01 1.305555555555555636e-01 1.284722222222222099e-01 1.261111111111111183e-01 1.241666666666666613e-01 1.220833333333333354e-01 1.162500000000000061e-01
1.280555555555555614e-01 1.268055555555555602e-01 1.254166666666666763e-01 1.222222222222222182e-01 1.181944444444444492e-01 1.162500000000000061e-01 1.169444444444444481e-01 1.172222222222222276e-01 1.220833333333333354e-01 1.237499999999999989e-01 1.262500000000000011e-01 1.265277777777777668e-01 1.288888888888888862e-01 1.308333333333333293e-01 1.305555555555555636e-01 1.329166666666666552e-01 1.322222222222222132e-01 1.288888888888888862e-01 1.248611111111111172e-01 1.211111111111111138e-01 1.190277777777777740e-01
1.205555555555555547e-01 1.245833333333333376e-01 1.243055555555555580e-01 1.206944444444444375e-01 1.202777777777777751e-01 1.170833333333333309e-01 1.155555555555555503e-01 1.179166666666666696e-01 1.198611111111111127e-01 1.234722222222222193e-01 1.280555555555555614e-01 1.305555555555555636e-01 1.312500000000000056e-01 1.326388888888888895e-01 1.322222222222222132e-01 1.350000000000000089e-01 1.336111111111111249e-01 1.318055555555555647e-01 1.258333333333333248e-01 1.219444444444444386e-01 1.188888888888888912e-01
1.197222222222222160e-01 1.222222222222222182e-01 1.208333333333333343e-01 1.179166666666666696e-01 1.179166666666666696e-01 1.173611111111111105e-01 1.159722222222222265e-01 1.188888888888888912e-01 1.222222222222222182e-01 1.238888888888888956e-01 1.261111111111111183e-01 1.288888888888888862e-01 1.304166666666666530e-01 1.311111111111111227e-01 1.298611111111111216e-01 1.344444444444444497e-01 1.326388888888888895e-01 1.294444444444444453e-01 1.268055555555555602e-01 1.208333333333333343e-01 1.176388888888888901e-01
1.176388888888888901e-01 1.198611111111111127e-01 1.226388888888888945e-01 1.194444444444444503e-01 1.183333333333333320e-01 1.194444444444444503e-01 1.187499999999999944e-01 1.209722222222222171e-01 1.244444444444444409e-01 1.256944444444444420e-01 1.270833333333333259e-01 1.280555555555555614e-01 1.272222222222222088e-01 1.287500000000000033e-01 1.275000000000000022e-01 1.287500000000000033e-01 1.298611111111111216e-01 1.295833333333333282e-01 1.281944444444444442e-01 1.211111111111111138e-01 1.172222222222222276e-01
1.156944444444444470e-01 1.179166666666666696e-01 1.198611111111111127e-01 1.194444444444444503e-01 1.184722222222222288e-01 1.186111111111111116e-01 1.186111111111111116e-01 1.194444444444444503e-01 1.243055555555555580e-01 1.259722222222222354e-01 1.259722222222222354e-01 1.272222222222222088e-01 1.269444444444444431e-01 1.279166666666666785e-01 1.244444444444444409e-01 1.254166666666666763e-01 1.256944444444444420e-01 1.268055555555555602e-01 1.247222222222222204e-01 1.168055555555555514e-01 1.138888888888888867e-01
1.144444444444444459e-01 1.183333333333333320e-01 1.212499999999999967e-01 1.220833333333333354e-01 1.213888888888888934e-01 1.202777777777777751e-01 1.223611111111111149e-01 1.220833333333333354e-01 1.269444444444444431e-01 1.259722222222222354e-01 1.286111111111111205e-01 1.309722222222222121e-01 1.294444444444444453e-01 1.259722222222222354e-01 1.261111111111111183e-01 1.255555555555555591e-01 1.255555555555555591e-01 1.272222222222222088e-01 1.212499999999999967e-01 1.158333333333333298e-01 1.116666666666666641e-01
1.154166666666666674e-01 1.201388888888888923e-01 1.199999999999999956e-01 1.220833333333333354e-01 1.236111111111111160e-01 1.220833333333333354e-01 1.223611111111111149e-01 1.234722222222222193e-01 1.280555555555555614e-01 1.263888888888888840e-01 1.266666666666666774e-01 1.301388888888888873e-01 1.288888888888888862e-01 1.279166666666666785e-01 1.277777777777777679e-01 1.255555555555555591e-01 1.234722222222222193e-01 1.243055555555555580e-01 1.191666666666666707e-01 1.151388888888888878e-01 1.059722222222222177e-01
1.188888888888888912e-01 1.194444444444444503e-01 1.201388888888888923e-01 1.209722222222222171e-01 1.245833333333333376e-01 1.255555555555555591e-01 1.255555555555555591e-01 1.261111111111111183e-01 1.266666666666666774e-01 1.240277777777777785e-01 1.275000000000000022e-01 1.275000000000000022e-01 1.272222222222222088e-01 1.272222222222222088e-01 1.244444444444444409e-01 1.233333333333333365e-01 1.198611111111111127e-01 1.190277777777777740e-01 1.172222222222222276e-01 1.102777777777777801e-01 1.033333333333333326e-01
1.216666666666666730e-01 1.244444444444444409e-01 1.251388888888888828e-01 1.234722222222222193e-01 1.233333333333333365e-01 1.245833333333333376e-01 1.270833333333333259e-01 1.258333333333333248e-01 1.269444444444444431e-01 1.236111111111111160e-01 1.270833333333333259e-01 1.275000000000000022e-01 1.273611111111111194e-01 1.287500000000000033e-01 1.238888888888888956e-01 1.218055555555555558e-01 1.190277777777777740e-01 1.168055555555555514e-01 1.140277777777777835e-01 1.079166666666666607e-01 9.916666666666666685e-02
1.218055555555555558e-01 1.256944444444444420e-01 1.277777777777777679e-01 1.251388888888888828e-01 1.223611111111111149e-01 1.266666666666666774e-01 1.270833333333333259e-01 1.248611111111111172e-01 1.268055555555555602e-01 1.261111111111111183e-01 1.266666666666666774e-01 1.247222222222222204e-01 1.254166666666666763e-01 1.254166666666666763e-01 1.211111111111111138e-01 1.199999999999999956e-01 1.172222222222222276e-01 1.154166666666666674e-01 1.108333333333333393e-01 1.034722222222222154e-01 9.597222222222222265e-02
1.243055555555555580e-01 1.295833333333333282e-01 1.325000000000000067e-01 1.298611111111111216e-01 1.276388888888888851e-01 1.277777777777777679e-01 1.293055555555555625e-01 1.295833333333333282e-01 1.272222222222222088e-01 1.262500000000000011e-01 1.269444444444444431e-01 1.251388888888888828e-01 1.230555555555555569e-01 1.254166666666666763e-01 1.215277777777777762e-01 1.197222222222222160e-01 1.172222222222222276e-01 1.122222222222222232e-01 1.069444444444444392e-01 9.986111111111110883e-02 9.333333333333333759e-02
1.276388888888888851e-01 1.315277777777777712e-01 1.350000000000000089e-01 1.329166666666666552e-01 1.320833333333333304e-01 1.300000000000000044e-01 1.334722222222222143e-01 1.319444444444444475e-01 1.280555555555555614e-01 1.263888888888888840e-01 1.269444444444444431e-01 1.250000000000000000e-01 1.238888888888888956e-01 1.229166666666666602e-01 1.184722222222222288e-01 1.173611111111111105e-01 1.144444444444444459e-01 1.088888888888888823e-01 1.043055555555555541e-01 9.972222222222222598e-02 9.208333333333333648e-02
1.290277777777777690e-01 1.340277777777777735e-01 1.343055555555555669e-01 1.341666666666666563e-01 1.343055555555555669e-01 1.330555555555555658e-01 1.361111111111110994e-01 1.334722222222222143e-01 1.313888888888888884e-01 1.275000000000000022e-01 1.248611111111111172e-01 1.220833333333333354e-01 1.208333333333333343e-01 1.188888888888888912e-01 1.163888888888888890e-01 1.137500000000000039e-01 1.125000000000000028e-01 1.079166666666666607e-01 1.027777777777777735e-01 9.638888888888888506e-02 8.861111111111111271e-02
1.308333333333333293e-01 1.338888888888888906e-01 1.372222222222222177e-01 1.354166666666666574e-01 1.348611111111110983e-01 1.352777777777777746e-01 1.352777777777777746e-01 1.351388888888888917e-01 1.348611111111110983e-01 1.287500000000000033e-01 1.262500000000000011e-01 1.211111111111111138e-01 1.184722222222222288e-01 1.155555555555555503e-01 1.137500000000000039e-01 1.118055555555555608e-01 1.086111111111111166e-01 1.043055555555555541e-01 1.000000000000000056e-01 9.180555555555555691e-02 8.527777777777777179e-02
1.294444444444444453e-01 1.337500000000000078e-01 1.351388888888888917e-01 1.356944444444444509e-01 1.354166666666666574e-01 1.341666666666666563e-01 1.331944444444444486e-01 1.327777777777777724e-01 1.313888888888888884e-01 1.254166666666666763e-01 1.248611111111111172e-01 1.173611111111111105e-01 1.174999999999999933e-01 1.122222222222222232e-01 1.113888888888888845e-01 1.101388888888888834e-01 1.031944444444444497e-01 9.902777777777778401e-02 9.486111111111110439e-02 8.874999999999999556e-02 7.875000000000000056e-02
1.313888888888888884e-01 1.318055555555555647e-01 1.343055555555555669e-01 1.336111111111111249e-01 1.329166666666666552e-01 1.333333333333333315e-01 1.331944444444444486e-01 1.322222222222222132e-01 1.283333333333333270e-01 1.223611111111111149e-01 1.205555555555555547e-01 1.174999999999999933e-01 1.137500000000000039e-01 1.120833333333333265e-01 1.079166666666666607e-01 1.058333333333333348e-01 1.004166666666666680e-01 9.638888888888888506e-02 9.069444444444443865e-02 8.444444444444444697e-02 7.763888888888888229e-02
1.259722222222222354e-01 1.263888888888888840e-01 1.294444444444444453e-01 1.284722222222222099e-01 1.284722222222222099e-01 1.301388888888888873e-01 1.286111111111111205e-01 1.279166666666666785e-01 1.231944444444444398e-01 1.193055555555555536e-01 1.161111111111111094e-01 1.120833333333333265e-01 1.081944444444444403e-01 1.061111111111111144e-01 1.018055555555555519e-01 9.819444444444444531e-02 9.555555555555556024e-02 9.013888888888889339e-02 8.652777777777777291e-02 8.041666666666666408e-02 7.152777777777777346e-02
1.209722222222222171e-01 1.218055555555555558e-01 1.238888888888888956e-01 1.251388888888888828e-01 1.251388888888888828e-01 1.222222222222222182e-01 1.224999999999999978e-01 1.201388888888888923e-01 1.181944444444444492e-01 1.138888888888888867e-01 1.093055555555555586e-01 1.062499999999999972e-01 1.018055555555555519e-01 1.000000000000000056e-01 9.750000000000000333e-02 9.152777777777777735e-02 8.986111111111111382e-02 8.500000000000000611e-02 8.055555555555556080e-02 7.611111111111111549e-02 7.000000000000000666e-02
