1.192488262910798152e-01 1.197853789403085234e-01 1.149564050972501639e-01 1.126760563380281716e-01 1.112005365526492345e-01 1.105298457411133528e-01 1.094567404426559365e-01 1.101274312541918182e-01 1.129443326626425187e-01 1.138832997987927614e-01 1.192488262910798152e-01 1.243460764587525219e-01 1.307847082494969781e-01 1.325285043594902623e-01 1.358819584171696848e-01 1.360160965794768584e-01 1.350771294433266156e-01 1.341381623071764007e-01 1.326626425217974636e-01 1.274312541918175834e-01 1.260898725687458199e-01
1.207243460764587523e-01 1.217974513749161686e-01 1.176391683433936908e-01 1.158953722334004066e-01 1.137491616364855740e-01 1.106639839034205264e-01 1.107981220657276999e-01 1.129443326626425187e-01 1.154929577464788720e-01 1.177733065057008782e-01 1.231388329979879320e-01 1.266264252179745142e-01 1.326626425217974636e-01 1.358819584171696848e-01 1.380281690140845174e-01 1.385647216633132117e-01 1.364185110663983791e-01 1.369550637156271011e-01 1.342723004694835742e-01 1.318578135479543945e-01 1.258215962441314451e-01
1.191146881287726417e-01 1.211267605633802869e-01 1.209926224010730994e-01 1.196512407780013360e-01 1.161636485580147538e-01 1.165660630449362883e-01 1.142857142857142821e-01 1.157612340710932192e-01 1.181757209926223989e-01 1.215291750503018076e-01 1.278336686787391041e-01 1.282360831656606248e-01 1.342723004694835742e-01 1.388329979879275589e-01 1.393695506371562809e-01 1.397719651240778016e-01 1.388329979879275589e-01 1.385647216633132117e-01 1.362843729040912055e-01 1.330650570087189843e-01 1.267605633802816878e-01
1.157612340710932192e-01 1.200536552649228705e-01 1.183098591549295725e-01 1.185781354795439335e-01 1.173708920187793436e-01 1.183098591549295725e-01 1.158953722334004066e-01 1.145539906103286432e-01 1.211267605633802869e-01 1.235412474849094527e-01 1.275653923541247570e-01 1.313212608987257002e-01 1.358819584171696848e-01 1.385647216633132117e-01 1.400402414486921487e-01 1.384305835010060381e-01 1.391012743125419060e-01 1.395036887994634545e-01 1.377598926894701425e-01 1.327967806841046372e-01 1.266264252179745142e-01
1.145539906103286432e-01 1.171026156941649965e-01 1.164319248826291148e-01 1.162977867203219273e-01 1.171026156941649965e-01 1.176391683433936908e-01 1.173708920187793436e-01 1.175050301810865172e-01 1.212608987256874604e-01 1.251509054325955772e-01 1.270288397048960349e-01 1.302481556002682839e-01 1.354795439302481641e-01 1.372233400402414483e-01 1.392354124748491073e-01 1.389671361502347324e-01 1.389671361502347324e-01 1.403085177733064959e-01 1.378940308517773439e-01 1.336016096579476786e-01 1.289067739771965204e-01
1.140174379610999350e-01 1.187122736418511071e-01 1.171026156941649965e-01 1.162977867203219273e-01 1.189805499664654542e-01 1.200536552649228705e-01 1.220657276995305157e-01 1.232729711602951056e-01 1.260898725687458199e-01 1.262240107310529935e-01 1.295774647887323883e-01 1.334674714956405051e-01 1.358819584171696848e-01 1.389671361502347324e-01 1.401743796109993223e-01 1.392354124748491073e-01 1.419181757209926342e-01 1.433936955063715712e-01 1.411133467471495651e-01 1.345405767940979214e-01 1.305164319248826310e-01
1.144198524480214557e-01 1.158953722334004066e-01 1.191146881287726417e-01 1.172367538564721701e-01 1.204560697518444051e-01 1.203219315895372177e-01 1.226022803487592239e-01 1.242119382964453345e-01 1.276995305164319305e-01 1.298457411133467354e-01 1.322602280348759152e-01 1.352112676056337892e-01 1.369550637156271011e-01 1.388329979879275589e-01 1.377598926894701425e-01 1.352112676056337892e-01 1.393695506371562809e-01 1.412474849094567386e-01 1.389671361502347324e-01 1.330650570087189843e-01 1.297116029510395618e-01
1.113346747149564081e-01 1.161636485580147538e-01 1.177733065057008782e-01 1.212608987256874604e-01 1.213950368879946340e-01 1.250167672702884036e-01 1.242119382964453345e-01 1.255533199195170979e-01 1.285043594902749720e-01 1.301140174379611103e-01 1.349429912810194421e-01 1.372233400402414483e-01 1.385647216633132117e-01 1.393695506371562809e-01 1.361502347417840320e-01 1.378940308517773439e-01 1.385647216633132117e-01 1.407109322602280443e-01 1.389671361502347324e-01 1.354795439302481641e-01 1.299798792756539367e-01
1.144198524480214557e-01 1.144198524480214557e-01 1.154929577464788720e-01 1.220657276995305157e-01 1.228705566733735710e-01 1.246143527833668690e-01 1.268947015425888614e-01 1.278336686787391041e-01 1.287726358148893469e-01 1.325285043594902623e-01 1.349429912810194421e-01 1.385647216633132117e-01 1.370892018779342747e-01 1.357478202548625112e-01 1.357478202548625112e-01 1.370892018779342747e-01 1.397719651240778016e-01 1.393695506371562809e-01 1.372233400402414483e-01 1.318578135479543945e-01 1.262240107310529935e-01
1.175050301810865172e-01 1.184439973172367599e-01 1.176391683433936908e-01 1.223340040241448629e-01 1.247484909456740426e-01 1.264922870556673407e-01 1.258215962441314451e-01 1.278336686787391041e-01 1.307847082494969781e-01 1.337357478202548522e-01 1.358819584171696848e-01 1.389671361502347324e-01 1.377598926894701425e-01 1.370892018779342747e-01 1.362843729040912055e-01 1.374916163648557954e-01 1.377598926894701425e-01 1.381623071763916910e-01 1.338698859825620258e-01 1.274312541918175834e-01 1.236753856472166263e-01
1.221998658618376893e-01 1.244802146210596955e-01 1.231388329979879320e-01 1.236753856472166263e-01 1.254191817572099243e-01 1.295774647887323883e-01 1.306505700871898046e-01 1.318578135479543945e-01 1.333333333333333315e-01 1.381623071763916910e-01 1.401743796109993223e-01 1.424547283702213285e-01 1.407109322602280443e-01 1.407109322602280443e-01 1.382964453386988646e-01 1.386988598256203853e-01 1.405767940979208708e-01 1.372233400402414483e-01 1.341381623071764007e-01 1.310529845741113253e-01 1.242119382964453345e-01
1.228705566733735710e-01 1.262240107310529935e-01 1.283702213279677984e-01 1.272971160295103821e-01 1.290409121395036940e-01 1.297116029510395618e-01 1.319919517102615680e-01 1.357478202548625112e-01 1.369550637156271011e-01 1.385647216633132117e-01 1.420523138832998078e-01 1.432595573440643977e-01 1.416498993963782593e-01 1.417840375586854329e-01 1.392354124748491073e-01 1.395036887994634545e-01 1.373574782025486218e-01 1.366867873910127540e-01 1.310529845741113253e-01 1.264922870556673407e-01 1.195171026156941624e-01
1.310529845741113253e-01 1.321260898725687416e-01 1.321260898725687416e-01 1.340040241448692271e-01 1.352112676056337892e-01 1.344064386317907478e-01 1.348088531187122685e-01 1.365526492287055804e-01 1.370892018779342747e-01 1.397719651240778016e-01 1.421864520456069814e-01 1.437961099932930920e-01 1.435278336686787448e-01 1.433936955063715712e-01 1.429912810194500228e-01 1.413816230717639122e-01 1.403085177733064959e-01 1.372233400402414483e-01 1.301140174379611103e-01 1.232729711602951056e-01 1.193829644533869888e-01
1.348088531187122685e-01 1.353454057679409905e-01 1.360160965794768584e-01 1.384305835010060381e-01 1.373574782025486218e-01 1.377598926894701425e-01 1.377598926894701425e-01 1.360160965794768584e-01 1.373574782025486218e-01 1.408450704225352179e-01 1.408450704225352179e-01 1.427230046948356756e-01 1.448692152917505083e-01 1.444668008048289876e-01 1.417840375586854329e-01 1.399061032863849752e-01 1.381623071763916910e-01 1.350771294433266156e-01 1.263581488933601671e-01 1.205902079141515787e-01 1.122736418511066370e-01
1.361502347417840320e-01 1.381623071763916910e-01 1.385647216633132117e-01 1.392354124748491073e-01 1.395036887994634545e-01 1.384305835010060381e-01 1.382964453386988646e-01 1.368209255533199276e-01 1.382964453386988646e-01 1.417840375586854329e-01 1.399061032863849752e-01 1.429912810194500228e-01 1.433936955063715712e-01 1.420523138832998078e-01 1.401743796109993223e-01 1.357478202548625112e-01 1.338698859825620258e-01 1.283702213279677984e-01 1.219315895372233421e-01 1.140174379610999350e-01 1.051643192488262851e-01
1.360160965794768584e-01 1.374916163648557954e-01 1.396378269617706280e-01 1.403085177733064959e-01 1.385647216633132117e-01 1.401743796109993223e-01 1.405767940979208708e-01 1.392354124748491073e-01 1.385647216633132117e-01 1.378940308517773439e-01 1.408450704225352179e-01 1.432595573440643977e-01 1.436619718309859184e-01 1.436619718309859184e-01 1.373574782025486218e-01 1.348088531187122685e-01 1.303822937625754574e-01 1.250167672702884036e-01 1.162977867203219273e-01 1.114688128772635817e-01 1.031522468142186399e-01
1.331991951710261579e-01 1.368209255533199276e-01 1.374916163648557954e-01 1.378940308517773439e-01 1.408450704225352179e-01 1.411133467471495651e-01 1.403085177733064959e-01 1.380281690140845174e-01 1.378940308517773439e-01 1.391012743125419060e-01 1.389671361502347324e-01 1.396378269617706280e-01 1.413816230717639122e-01 1.388329979879275589e-01 1.346747149564050949e-01 1.321260898725687416e-01 1.271629778672032085e-01 1.207243460764587523e-01 1.130784708249496923e-01 1.038229376257545217e-01 9.604292421193830198e-02
1.315895372233400473e-01 1.345405767940979214e-01 1.356136820925553377e-01 1.396378269617706280e-01 1.423205902079141549e-01 1.427230046948356756e-01 1.404426559356136694e-01 1.400402414486921487e-01 1.397719651240778016e-01 1.393695506371562809e-01 1.374916163648557954e-01 1.376257545271629690e-01 1.381623071763916910e-01 1.357478202548625112e-01 1.303822937625754574e-01 1.262240107310529935e-01 1.230046948356807446e-01 1.187122736418511071e-01 1.054325955734406461e-01 9.845741113346746787e-02 9.054325955734406073e-02
1.279678068410462777e-01 1.319919517102615680e-01 1.333333333333333315e-01 1.373574782025486218e-01 1.377598926894701425e-01 1.382964453386988646e-01 1.365526492287055804e-01 1.369550637156271011e-01 1.337357478202548522e-01 1.336016096579476786e-01 1.309188464118041517e-01 1.303822937625754574e-01 1.345405767940979214e-01 1.299798792756539367e-01 1.240778001341381609e-01 1.234071093226022792e-01 1.169684775318578090e-01 1.121395036887994634e-01 1.022132796780684111e-01 9.362843729040912222e-02 8.571428571428571508e-02
1.243460764587525219e-01 1.258215962441314451e-01 1.301140174379611103e-01 1.322602280348759152e-01 1.338698859825620258e-01 1.340040241448692271e-01 1.306505700871898046e-01 1.294433266264252147e-01 1.256874580818242715e-01 1.264922870556673407e-01 1.264922870556673407e-01 1.250167672702884036e-01 1.267605633802816878e-01 1.236753856472166263e-01 1.192488262910798152e-01 1.152246814218645249e-01 1.075788061703554649e-01 1.004694835680751130e-01 9.577464788732394096e-02 8.826291079812206841e-02 8.034875922199866127e-02
1.209926224010730994e-01 1.231388329979879320e-01 1.262240107310529935e-01 1.295774647887323883e-01 1.283702213279677984e-01 1.274312541918175834e-01 1.238095238095238138e-01 1.235412474849094527e-01 1.204560697518444051e-01 1.217974513749161686e-01 1.208584842387659258e-01 1.193829644533869888e-01 1.193829644533869888e-01 1.177733065057008782e-01 1.107981220657276999e-01 1.066398390342052360e-01 9.872568745808182888e-02 9.362843729040912222e-02 8.853118712273641555e-02 8.236083165660630645e-02 7.458081824279007288e-02
